Employee_ID,Department,Emails_Sent,Emails_Received,Meetings_Hours,Z_Score,Docs_Created,Sheets_Collaborated,Tasks_Completed,Week,Collaboration_Index,Productivity_Score,Communication_Load,Collaboration_Load
E0001,Support,49,82,10.49560827,0,11,12,20,12,2.000764071,1.739794844,131,23
E0002,Engineering,48,86,14.87464323,2,17,5,15,9,1.385857917,0.944903125,134,22
E0003,Finance,48,74,12.44652201,1,14,6,17,11,1.487373462,1.264267443,122,20
E0004,Support,74,68,4.703597478,-2,9,8,18,2,2.980574991,3.155902931,142,17
E0005,HR,58,70,14.16616734,1,7,3,11,5,0.659362367,0.725298604,128,10
E0006,Finance,41,76,13.6128387,1,7,4,17,5,0.752762706,1.163360545,117,11
E0007,Finance,44,82,14.62938455,2,11,5,24,11,1.023712734,1.535569102,126,16
E0008,Support,55,74,13.32732554,1,13,4,15,6,1.18654385,1.046950456,129,17
E0009,Marketing,48,67,8.421592487,-1,9,5,20,3,1.48594837,2.122783386,115,14
E0010,HR,58,82,4.435256129,-2,6,0,18,7,1.103903819,3.311711458,140,6
E0011,Support,48,62,13.51277859,1,6,5,23,5,0.757952719,1.584810231,110,11
E0012,HR,58,54,12.3297984,1,3,6,21,6,0.675179004,1.575417675,112,9
E0013,HR,60,75,4.084206357,-2,7,7,23,11,2.753625446,4.523813233,135,14
E0014,Finance,43,82,7.107105224,-1,12,6,15,12,2.220274624,1.850228853,125,18
E0015,Engineering,46,74,7.191376883,-1,13,6,25,6,2.319512369,3.051989959,120,19
E0016,HR,47,68,12.18241355,1,6,4,22,7,0.758586428,1.668890141,115,10
E0017,Operations,60,62,9.95349918,0,11,2,21,7,1.186835347,1.917195561,122,13
E0018,Finance,39,65,9.208954113,0,8,5,21,4,1.273391951,2.057017768,104,13
E0019,Marketing,56,65,8.741562525,0,7,5,21,1,1.231835239,2.155711668,121,12
E0020,Engineering,58,85,6.62299721,-1,7,4,16,1,1.443001971,2.098911958,143,11
E0021,Operations,49,65,12.89614564,1,7,4,20,1,0.791586407,1.439248013,114,11
E0022,Operations,48,63,7.819331357,-1,8,5,16,3,1.474034649,1.814196491,111,13
E0023,Marketing,51,82,13.48712865,1,11,6,24,2,1.173455445,1.656642981,133,17
E0024,Engineering,36,79,5.820885409,-1,9,2,13,12,1.612693857,1.905910922,115,11
E0025,Finance,55,72,8.524085036,-1,7,4,16,5,1.154966588,1.679951401,127,11
E0026,Sales,43,64,15.89449977,2,6,5,22,5,0.651099479,1.302198958,107,11
E0027,Engineering,49,87,10.70386694,0,15,6,21,5,1.794278773,1.794278773,136,21
E0028,Marketing,34,56,8.528359429,-1,10,5,18,3,1.574247919,1.889097503,90,15
E0029,Operations,46,64,8.115740237,-1,8,2,24,4,1.097003616,2.632808678,110,10
E0030,Finance,53,64,7.391817841,-1,2,7,20,10,1.072473232,2.383273848,117,9
E0031,Engineering,56,55,11.36109092,0,12,7,20,5,1.537081162,1.617980171,111,19
E0032,Sales,60,82,12.69578935,1,5,7,19,3,0.8761817,1.387287692,142,12
E0033,Sales,44,66,10.75389172,0,5,4,25,6,0.765703838,2.126955104,110,9
E0034,HR,40,72,9.822347537,0,9,5,21,8,1.293619518,1.940429276,112,14
E0035,HR,44,67,11.80470613,1,11,2,24,6,1.015251726,1.874310879,111,13
E0036,Support,51,66,5.786325686,-1,6,7,19,7,1.915616875,2.79974774,117,13
E0037,Marketing,47,74,11.1342462,0,2,3,23,3,0.41205691,1.895461787,121,5
E0038,Engineering,56,65,11.30396306,0,10,2,23,2,0.975295516,1.869316405,121,12
E0039,Engineering,45,64,10.80205909,0,8,5,31,2,1.101502704,2.626660293,109,13
E0040,Support,45,65,8.33431155,-1,9,5,21,1,1.499842803,2.249764205,110,14
E0041,Operations,50,66,7.674870418,-1,3,2,21,7,0.576377486,2.42078544,116,5
E0042,Operations,66,63,6.097513565,-1,4,5,17,1,1.268049708,2.395205003,129,9
E0043,Support,41,66,14.41174472,1,7,7,26,1,0.908398125,1.687025089,107,14
E0044,Operations,56,74,9.832968061,0,8,4,21,12,1.107729657,1.938526901,130,12
E0045,HR,49,72,8.728611153,0,7,6,30,1,1.336264735,3.083687849,121,13
E0046,Engineering,42,63,8.436310368,-1,8,7,24,1,1.589604349,2.543366959,105,15
E0047,Support,57,63,7.130521475,-1,15,4,21,11,2.336873478,2.58286016,120,19
E0048,Engineering,47,71,8.392888196,-1,7,4,16,10,1.17109879,1.703416422,118,11
E0049,Sales,34,83,13.63368901,1,10,4,21,6,0.956696564,1.435044846,117,14
E0050,HR,43,85,11.74513382,1,7,4,24,3,0.8630745,1.883071637,128,11
E0051,Finance,42,84,12.48548023,1,7,6,18,2,0.963999782,1.334768929,126,13
E0052,HR,56,75,12.87785922,1,6,8,21,3,1.008801125,1.513201688,131,14
E0053,Support,49,63,16.5994904,2,8,6,18,8,0.795477578,1.022756886,112,14
E0054,Finance,46,84,10.08316055,0,11,8,18,11,1.71431244,1.62408547,130,19
E0055,Sales,50,73,8.716036206,0,7,5,26,10,1.235071561,2.675988381,123,12
E0056,Support,61,68,11.31153182,0,2,4,23,4,0.487347967,1.868167205,129,6
E0057,Marketing,56,68,11.94602983,1,6,5,19,7,0.849681342,1.467631409,124,11
E0058,Engineering,57,68,9.897862514,0,8,3,23,2,1.009372249,2.110505613,125,11
E0059,Sales,58,66,7.318107444,-1,10,6,21,10,1.923514466,2.524612737,124,16
E0060,Engineering,51,78,10.55799033,0,5,7,11,2,1.038242779,0.951722548,129,12
E0061,Operations,54,63,11.633471,1,7,2,10,7,0.712393292,0.791548103,117,9
E0062,Marketing,51,68,11.04216452,0,5,3,23,2,0.664332395,1.909955636,119,8
E0063,Marketing,46,73,4.487082093,-2,10,4,20,3,2.551447156,3.644924509,119,14
E0064,Sales,44,70,5.229731501,-2,11,2,22,1,2.086767302,3.531452358,114,13
E0065,Marketing,57,74,12.15035284,1,11,5,15,4,1.216697391,1.140653804,131,16
E0066,Finance,53,77,8.883067498,0,6,1,21,9,0.70828212,2.12484636,130,7
E0067,Marketing,57,66,16.67371775,2,10,3,24,11,0.735555483,1.357948585,123,13
E0068,Engineering,37,73,14.0234822,1,7,2,17,12,0.59906218,1.131561896,110,9
E0069,Engineering,44,66,6.195610148,-1,8,6,17,10,1.945630699,2.362551563,110,14
E0070,Support,43,66,13.07954585,1,7,3,16,6,0.710250182,1.136400291,109,10
E0071,Engineering,48,71,14.80173061,2,6,3,31,8,0.569557868,1.961810435,119,9
E0072,Support,48,71,8.664179102,0,11,7,16,7,1.862548263,1.655598456,119,18
E0073,Engineering,48,61,9.741467138,0,3,9,16,8,1.117165825,1.489554434,109,12
E0074,Finance,52,82,8.355888854,-1,9,2,26,11,1.175730085,2.778998383,134,11
E0075,Support,47,72,6.632030683,-1,8,4,18,1,1.572320723,2.358481084,119,12
E0076,HR,46,71,14.73093384,2,14,5,16,1,1.207811322,1.017104271,117,19
E0077,Operations,37,72,2.230078517,-3,6,7,26,12,4.024669967,8.049339934,109,13
E0078,Sales,56,78,7.97625648,-1,8,5,29,8,1.448265213,3.230745474,134,13
E0079,Engineering,40,60,8.732621992,0,12,5,23,6,1.746702997,2.363186407,100,17
E0080,Marketing,56,69,10.47156387,0,2,4,20,10,0.523032437,1.743441455,125,6
E0081,Engineering,64,71,6.28091124,-1,9,3,24,6,1.648145349,3.296290699,135,12
E0082,Marketing,51,77,14.06480316,1,6,8,24,8,0.929318482,1.593117397,128,14
E0083,Operations,52,53,4.492300891,-2,7,6,17,12,2.36694971,3.095241928,105,13
E0084,Operations,50,75,4.536182507,-2,10,10,21,4,3.612597665,3.793227548,125,20
E0085,Operations,52,73,10.17415933,0,10,8,24,1,1.610859436,2.147812582,125,18
E0086,Marketing,55,75,6.139140753,-1,11,4,15,7,2.101093187,2.101093187,130,15
E0087,Engineering,51,57,10.62327386,0,10,4,17,2,1.204479923,1.462582763,108,14
E0088,Operations,41,65,7.779718911,-1,8,6,25,7,1.59458408,2.847471571,106,14
E0089,Finance,37,74,12.42218657,1,13,7,17,8,1.490070183,1.266559655,111,20
E0090,Support,54,84,7.216394183,-1,7,5,26,6,1.460494681,3.164405142,138,12
E0091,Marketing,39,74,14.33365232,1,7,4,17,10,0.717376381,1.108672588,113,11
E0092,Marketing,53,63,11.88822254,1,5,8,20,2,1.008672837,1.551804365,116,13
E0093,Engineering,47,75,7.725714119,-1,12,8,22,7,2.29207601,2.521283611,122,20
E0094,Marketing,49,61,11.87273921,1,6,8,20,9,1.087569613,1.553670875,110,14
E0095,Marketing,52,54,10.43804783,0,7,9,22,10,1.398840103,1.923405141,106,16
E0096,Operations,44,74,12.35653158,1,9,5,23,1,1.048176311,1.72200394,118,14
E0097,Engineering,42,69,11.79833099,1,8,2,22,6,0.781351881,1.718974139,111,10
E0098,Operations,49,71,11.07786059,0,7,5,23,7,0.993553445,1.90431077,120,12
E0099,Support,53,76,10.19395616,0,7,2,30,4,0.804005293,2.680017642,129,9
E0100,Support,48,81,12.71342197,1,10,8,19,7,1.312582669,1.385503928,129,18
E0101,Operations,51,67,13.51178977,1,6,2,27,3,0.551275902,1.86055617,118,8
E0102,Support,44,62,10.409701,0,5,6,24,10,0.964091872,2.103473176,106,11
E0103,Engineering,52,77,11.8184457,1,2,1,21,9,0.234037735,1.638264146,129,3
E0104,Sales,43,70,12.81177464,1,8,11,22,1,1.375637853,1.592843829,113,19
E0105,Operations,50,67,14.82078108,2,14,4,19,4,1.137744079,1.200952083,117,18
E0106,Finance,46,55,14.29637036,1,4,6,32,8,0.653749861,2.091999556,101,10
E0107,Finance,38,66,13.08957054,1,12,4,19,3,1.135591745,1.348515198,104,16
E0108,Marketing,50,64,8.757632673,0,8,10,19,6,1.844709737,1.947193611,114,18
E0109,Support,51,83,6.061377044,-1,10,5,20,3,2.124231564,2.832308752,134,15
E0110,Finance,54,82,11.67789127,1,12,2,22,2,1.104284593,1.735304361,136,14
E0111,Marketing,53,81,11.65518105,1,6,1,21,12,0.553133137,1.659399412,134,7
E0112,Sales,61,85,8.80917343,0,8,7,18,8,1.529180833,1.835017,146,15
E0113,Engineering,48,71,5.997255865,-1,5,3,22,4,1.143305341,3.144089687,119,8
E0114,Engineering,52,69,14.96738054,2,3,6,22,9,0.563649121,1.377808962,121,9
E0115,Engineering,47,73,11.27678176,0,8,6,14,7,1.140364004,1.140364004,120,14
E0116,Finance,60,55,6.37526186,-1,5,6,30,7,1.491472467,4.067652182,115,11
E0117,Sales,50,70,9.61906152,0,5,5,28,10,0.941702803,2.636767849,120,10
E0118,Finance,56,80,5.968945466,-1,1,8,22,7,1.291443597,3.156862126,136,9
E0119,Support,50,67,12.0453527,1,7,4,22,4,0.843212158,1.686424315,117,11
E0120,Finance,56,78,15.55024445,2,4,4,18,11,0.483376546,1.087597229,134,8
E0121,Sales,43,71,9.441930933,0,4,4,17,12,0.766141823,1.628051374,114,8
E0122,Sales,46,69,9.722542759,0,10,6,22,1,1.492183371,2.051752135,115,16
E0123,Support,48,69,9.171139492,0,8,6,19,12,1.376443614,1.868030619,117,14
E0124,Sales,53,70,9.326810439,0,3,11,25,3,1.355694489,2.420883016,123,14
E0125,Sales,50,64,7.672224036,-1,9,7,20,10,1.844970786,2.306213483,114,16
E0126,Engineering,41,68,14.14612858,1,9,2,17,10,0.726258195,1.122399028,109,11
E0127,Support,48,58,10.58508401,0,11,4,19,4,1.294768341,1.640039899,106,15
E0128,HR,56,61,10.19014873,0,8,9,20,9,1.519193392,1.787286343,117,17
E0129,HR,43,58,9.321839334,0,14,2,11,2,1.550111321,1.065701533,101,16
E0130,Sales,48,66,6.181310638,-1,6,5,26,11,1.53175382,3.620509028,114,11
E0131,HR,45,73,12.81514648,1,5,6,26,8,0.796227533,1.881992351,118,11
E0132,HR,62,62,14.26887605,1,5,8,20,8,0.851405169,1.309854107,124,13
E0133,Sales,50,76,4.415596483,-2,4,6,26,1,1.846518667,4.800948535,126,10
E0134,HR,65,67,12.12834159,1,8,4,19,1,0.914052999,1.447250581,132,12
E0135,Finance,55,74,12.58735226,1,10,4,17,4,1.030369989,1.251163559,129,14
E0136,Marketing,49,65,13.85261556,1,6,2,22,7,0.53862567,1.481220591,114,8
E0137,Support,49,78,13.61639567,1,11,5,13,1,1.094661117,0.889412157,127,16
E0138,Marketing,45,56,17.90740796,3,6,5,26,5,0.581782549,1.375122389,101,11
E0139,Sales,58,63,11.20078187,0,4,11,21,8,1.229429405,1.721201168,121,15
E0140,Engineering,57,53,12.97803457,1,8,5,28,5,0.930030609,2.00314285,110,13
E0141,Support,53,55,10.03729674,0,9,3,20,6,1.087222739,1.812037899,108,12
E0142,Sales,45,74,7.591495471,-1,12,6,24,1,2.095095093,2.793460124,119,18
E0143,Engineering,46,76,12.12482032,1,8,6,17,4,1.066681269,1.295255827,122,14
E0144,Marketing,38,68,12.981382,1,6,2,13,8,0.572189502,0.92980794,106,8
E0145,Sales,47,68,11.02535492,0,7,2,20,6,0.748418659,1.663152576,115,9
E0146,Support,47,74,5.019264302,-2,10,4,26,3,2.325865637,4.319464755,121,14
E0147,Support,48,76,5.653130436,-1,5,8,17,2,1.953967403,2.555188142,124,13
E0148,Operations,46,59,12.301885,1,7,3,31,3,0.751773151,2.330496769,105,10
E0149,Finance,48,76,8.902788645,0,8,5,21,9,1.312761533,2.120614784,124,13
E0150,HR,48,81,11.06827988,0,11,6,26,9,1.408651454,2.154408106,129,17
E0151,Engineering,48,70,11.44807365,0,6,7,27,4,1.044338294,2.169010302,118,13
E0152,Operations,59,56,9.656749181,0,10,4,23,4,1.313721451,2.15825667,115,14
E0153,HR,56,77,9.231747249,0,6,6,20,11,1.172820214,1.954700357,133,12
E0154,HR,51,71,9.609199117,0,8,8,15,2,1.508125149,1.413867327,122,16
E0155,Sales,48,64,11.77447073,1,6,3,13,7,0.704530167,1.017654686,112,9
E0156,HR,60,64,11.43999385,0,8,1,21,1,0.723473026,1.688103728,124,9
E0157,Finance,53,56,7.603076208,-1,5,4,19,5,1.046137426,2.208512344,109,9
E0158,Support,40,77,9.955491926,0,7,5,17,2,1.095341047,1.55173315,117,12
E0159,Operations,46,50,6.817879342,-1,10,4,16,9,1.790766957,2.046590808,96,14
E0160,HR,44,71,11.54306725,1,7,6,24,7,1.036429108,1.913407583,115,13
E0161,Sales,46,79,8.603373351,0,7,5,21,12,1.249560916,2.186731603,125,12
E0162,Finance,48,82,12.15931639,1,9,5,28,11,1.063885052,2.127770104,130,14
E0163,Marketing,59,66,9.278712442,0,8,10,20,10,1.751192097,1.945768997,125,18
E0164,Support,48,56,13.43201808,1,6,9,19,4,1.039355683,1.316517198,104,15
E0165,Support,43,63,13.99917935,1,3,5,21,11,0.533362514,1.400076598,106,8
E0166,Operations,51,61,11.33260402,0,10,8,14,3,1.459545767,1.135202264,112,18
E0167,Support,54,65,8.898270162,0,7,7,21,6,1.414388552,2.121582828,119,14
E0168,HR,63,64,7.188108423,-1,7,2,18,8,1.099154962,2.198309923,127,9
E0169,Sales,40,62,12.88489628,1,13,8,16,6,1.512434777,1.152331259,102,21
E0170,Support,54,62,9.801419763,0,8,5,23,10,1.203545486,2.129349706,116,13
E0171,Support,52,79,10.14445003,0,6,5,16,3,0.987038389,1.435692202,131,11
E0172,Marketing,54,68,8.834790118,0,6,8,21,3,1.423517923,2.135276884,122,14
E0173,Marketing,60,69,5.851619342,-1,6,4,21,5,1.459508986,3.064968871,129,10
E0174,Engineering,55,62,13.22344906,1,7,3,18,10,0.703064352,1.265515834,117,10
E0175,Finance,56,68,9.745856528,0,13,5,19,3,1.67506424,1.768123365,124,18
E0176,HR,59,71,4.41325098,-2,6,1,18,1,1.293123121,3.325173739,130,7
E0177,Support,41,82,9.585914207,0,12,6,21,4,1.700372745,1.983768203,123,18
E0178,Support,51,75,5.935918395,-1,6,6,15,3,1.730124162,2.162655202,126,12
E0179,Sales,57,54,11.77113585,1,8,7,17,11,1.174523565,1.331126707,111,15
E0180,Engineering,50,89,11.35900973,0,9,3,19,11,0.970951578,1.537339998,139,12
E0181,Finance,48,60,14.52476392,1,13,2,23,6,0.966198268,1.48150401,108,15
E0182,Engineering,43,72,5.570246948,-1,9,7,22,12,2.435220491,3.348428175,115,16
E0183,Operations,50,74,14.31162442,1,7,3,22,5,0.653098569,1.436816852,124,10
E0184,Finance,55,86,11.55800424,1,6,9,24,2,1.194457313,1.9111317,141,15
E0185,Support,49,59,5.899260487,-1,7,5,26,2,1.739316847,3.768519836,108,12
E0186,Support,65,74,15.48105253,2,7,4,17,10,0.667433101,1.03148752,139,11
E0187,Finance,49,86,9.62662249,0,12,7,19,2,1.787962263,1.787962263,135,19
E0188,Support,55,60,6.426295825,-1,7,6,24,8,1.750536244,3.23175922,115,13
E0189,HR,54,76,13.11874923,1,14,8,19,2,1.558211684,1.345728272,130,22
E0190,Finance,47,68,6.733280699,-1,10,4,10,1,1.810357149,1.293112249,115,14
E0191,Engineering,47,63,13.4686633,1,8,2,16,6,0.69114885,1.10583816,110,10
E0192,Finance,47,73,9.424130599,0,6,3,25,5,0.863381355,2.398281541,120,9
E0193,Support,58,66,8.952330848,0,11,3,17,3,1.406705647,1.708142571,124,14
E0194,HR,53,65,6.095076578,-1,9,6,19,4,2.114142086,2.677913309,118,15
E0195,HR,39,67,6.869227985,-1,10,6,19,10,2.033236301,2.414468107,106,16
E0196,Operations,52,71,10.48139582,0,15,8,19,8,2.003240753,1.654851057,123,23
E0197,Engineering,51,76,5.082398005,-2,13,5,18,2,2.959359119,2.959359119,127,18
E0198,Marketing,47,66,12.06767591,1,9,5,24,5,1.071345823,1.836592839,113,14
E0199,Marketing,56,67,8.425558423,-1,8,7,14,5,1.591417646,1.485323136,123,15
E0200,Finance,43,80,8.810833064,0,8,5,15,12,1.325065865,1.528922152,123,13
E0201,Operations,48,75,11.74949461,1,5,6,26,4,0.862779297,2.03929652,123,11
E0202,Sales,47,92,9.387781986,0,11,9,17,12,1.925338829,1.636538004,139,20
E0203,Finance,42,79,13.69172879,1,8,7,23,2,1.020982637,1.56550671,121,15
E0204,Operations,52,81,3.848934279,-2,8,4,26,5,2.474770601,5.362002969,133,12
E0205,Engineering,51,71,12.40135681,1,8,6,15,1,1.044670342,1.119289652,122,14
E0206,Engineering,46,68,10.07226682,0,4,3,22,6,0.632210198,1.986946336,114,7
E0207,Engineering,55,66,8.026355606,-1,7,7,16,4,1.551013566,1.772586933,121,14
E0208,Engineering,52,62,12.84697338,1,4,2,19,6,0.433307686,1.372141007,114,6
E0209,Engineering,52,64,11.76047131,1,9,3,25,8,0.940404136,1.959175284,116,12
E0210,Operations,59,76,10.68501777,0,2,6,17,6,0.684637384,1.454854441,135,8
E0211,Operations,55,67,9.240760837,0,8,3,19,6,1.074138941,1.855330898,122,11
E0212,HR,52,70,7.88360198,-1,10,3,30,12,1.463370379,3.377008568,122,13
E0213,Marketing,49,67,6.763173817,-1,9,7,13,7,2.061012722,1.674572837,116,16
E0214,Support,68,66,14.09780552,1,10,2,18,1,0.794817497,1.192226246,134,12
E0215,Engineering,51,66,12.48020755,1,4,2,9,10,0.445097005,0.667645507,117,6
E0216,Sales,53,62,11.70596109,1,7,4,20,10,0.865735376,1.57406432,115,11
E0217,Support,44,69,8.719008014,0,8,5,26,7,1.337585069,2.675170137,113,13
E0218,Operations,58,77,16.10167875,2,7,5,17,8,0.7016855,0.994054458,135,12
E0219,Sales,45,68,7.916655964,-1,8,3,16,6,1.233646341,1.794394677,113,11
E0220,Sales,58,66,8.865784514,0,8,5,25,9,1.317685378,2.534010343,124,13
E0221,Sales,56,45,15.43886288,2,4,3,23,2,0.425820207,1.399123538,101,7
E0222,HR,56,69,9.842773214,0,13,6,26,7,1.752319229,2.397910524,125,19
E0223,Operations,55,74,15.21432913,2,8,5,15,2,0.801759968,0.925107655,129,13
E0224,Sales,44,71,11.13578564,0,3,6,19,8,0.741608353,1.565617634,115,9
E0225,Engineering,45,73,8.455666043,-1,11,1,29,12,1.269080353,3.066944186,118,12
E0226,Finance,60,71,9.412572616,0,5,5,21,11,0.960377456,2.016792658,131,10
E0227,Sales,53,74,7.849583434,-1,6,4,18,7,1.129996691,2.033994044,127,10
E0228,HR,56,64,12.07999866,1,7,3,20,4,0.764526072,1.529052145,120,10
E0229,Support,43,62,13.66866721,1,8,1,15,11,0.613552675,1.022587791,105,9
E0230,Operations,55,60,11.4019762,0,8,6,21,8,1.128852351,1.693278527,115,14
E0231,HR,53,78,10.850889,0,7,6,18,5,1.096964118,1.518873395,131,13
E0232,Sales,55,79,6.882296231,-1,11,13,19,1,3.044798025,2.410465103,134,24
E0233,Operations,63,67,13.28017751,1,3,6,21,4,0.630244267,1.470569956,130,9
E0234,Finance,54,85,12.51969066,1,10,10,17,4,1.479323788,1.25742522,139,20
E0235,Sales,49,75,10.83427648,0,6,5,12,11,0.929503381,1.014003688,124,11
E0236,HR,46,85,9.095881736,0,8,3,20,1,1.089553175,1.981005773,131,11
E0237,Marketing,58,72,10.13171462,0,9,5,9,10,1.257667886,0.808500784,130,14
E0238,Engineering,46,79,7.270321714,-1,9,3,22,3,1.450971367,2.660114172,125,12
E0239,Support,54,73,5.577046347,-1,8,2,20,11,1.520439339,3.040878678,127,10
E0240,HR,41,65,9.100458288,0,4,5,19,6,0.891048678,1.881102764,106,9
E0241,Operations,48,71,7.419926848,-1,6,9,25,9,1.781488161,2.969146936,119,15
E0242,Sales,48,63,8.477092757,-1,5,3,23,12,0.84414073,2.426904599,111,8
E0243,Engineering,53,78,8.536146424,0,5,1,12,6,0.62918497,1.25836994,131,6
E0244,Sales,54,62,9.765923502,0,5,4,22,2,0.835971015,2.043484704,116,9
E0245,Operations,52,70,9.568914647,0,7,7,29,2,1.324639328,2.743895752,122,14
E0246,Sales,59,74,0.840539905,-3,7,2,22,10,4.889869529,11.9530144,133,9
E0247,Marketing,47,68,11.04369264,0,9,6,17,1,1.245465195,1.411527221,115,15
E0248,Engineering,53,61,10.39448962,0,9,6,21,4,1.31642579,1.842996106,114,15
E0249,Engineering,49,66,12.88344297,1,4,2,17,12,0.432169456,1.224480126,115,6
E0250,Operations,59,51,9.358569698,0,8,8,19,11,1.544614794,1.834230068,110,16
E0251,Support,64,66,13.25330073,1,12,2,16,1,0.982228627,1.122547002,130,14
E0252,Marketing,47,67,9.540907714,0,9,4,15,7,1.233290372,1.423027353,114,13
E0253,HR,40,66,11.02023578,0,7,4,23,9,0.91512348,1.913440005,106,11
E0254,Sales,53,73,7.248595188,-1,5,7,18,8,1.454793177,2.182189766,126,12
E0255,Finance,37,57,13.40824073,1,12,5,21,7,1.179880342,1.457499246,94,17
E0256,Sales,55,60,13.89999282,1,3,9,17,2,0.805369515,1.140940147,115,12
E0257,Sales,48,74,15.64994706,2,9,8,13,2,1.021024267,0.780783263,122,17
E0258,HR,49,69,8.372675707,-1,8,8,21,3,1.707089896,2.240555489,118,16
E0259,Sales,36,81,11.58905691,1,10,4,21,8,1.112076949,1.668115424,117,14
E0260,Marketing,49,81,5.680604796,-1,10,5,15,2,2.245305696,2.245305696,130,15
E0261,Marketing,60,67,4.33829852,-2,12,7,21,10,3.559186495,3.933837705,127,19
E0262,Engineering,58,69,11.69030686,1,7,4,22,2,0.866803311,1.733606621,127,11
E0263,Operations,38,72,9.661479559,0,2,8,25,4,0.93795612,2.3448903,110,10
E0264,Support,39,79,6.144729859,-1,7,5,19,6,1.679559653,2.659302783,118,12
E0265,Finance,54,66,10.53739181,0,11,5,21,11,1.386795237,1.820168748,120,16
E0266,Sales,52,89,12.80092255,1,9,6,23,2,1.086883862,1.666555255,141,15
E0267,Sales,54,70,10.18929636,0,5,6,13,9,0.983082372,1.161824621,124,11
E0268,HR,54,61,13.68543221,1,10,1,32,9,0.749041625,2.17903018,115,11
E0269,Operations,40,63,8.017731741,-1,4,13,21,1,1.88517473,2.328745255,103,17
E0270,Marketing,44,63,13.24823102,1,12,1,20,1,0.912393965,1.403683024,107,13
E0271,Finance,52,75,8.848687652,0,6,5,17,10,1.116900077,1.726118301,127,11
E0272,Engineering,64,67,13.69049679,1,5,3,13,9,0.544569739,0.884925825,131,8
E0273,Marketing,41,78,6.186427435,-1,11,6,19,1,2.365570397,2.643872796,119,17
E0274,Operations,49,73,10.69220639,0,6,2,20,7,0.684216454,1.710541136,122,8
E0275,Support,46,78,10.68585966,0,6,3,17,11,0.770161568,1.454749629,124,9
E0276,Engineering,56,55,11.43134772,0,9,4,20,5,1.045743414,1.608836021,111,13
E0277,Support,42,71,8.945740294,0,10,4,19,10,1.407637801,1.910365588,113,14
E0278,HR,37,82,11.29502958,0,8,4,17,6,0.976004159,1.382672558,119,12
E0279,HR,42,67,9.405137519,0,9,5,30,4,1.345489185,2.883191111,109,14
E0280,Sales,43,70,8.420251899,-1,6,12,19,2,1.91077693,2.016931203,113,18
E0281,Support,44,67,14.24227821,1,12,7,18,3,1.246532817,1.180925827,111,19
E0282,Operations,58,62,10.23409762,0,11,3,12,10,1.246206012,1.068176582,120,14
E0283,Finance,47,61,5.458505912,-2,6,4,22,8,1.548345722,3.406360589,108,10
E0284,Engineering,61,71,7.980909854,-1,11,3,18,2,1.558862101,2.004251272,132,14
E0285,Marketing,45,71,14.35446188,1,12,6,21,7,1.172297677,1.367680624,116,18
E0286,Operations,58,66,7.274178536,-1,13,3,23,12,1.933726705,2.779732139,124,16
E0287,Operations,52,73,11.62253462,1,3,4,13,3,0.55456374,1.029904088,125,7
E0288,HR,49,62,7.916373943,-1,13,5,23,11,2.018757862,2.579523935,111,18
E0289,Support,46,73,5.685386009,-1,4,7,25,2,1.645379936,3.739499853,119,11
E0290,Sales,59,82,11.44136466,0,5,4,26,10,0.723393313,2.089802904,141,9
E0291,Sales,55,55,9.014242276,0,1,4,27,4,0.499288899,2.696160054,110,5
E0292,Engineering,47,82,14.7655853,2,8,7,17,9,0.951439462,1.078298057,129,15
E0293,HR,47,74,13.37663167,1,6,6,16,7,0.834687866,1.112917154,121,12
E0294,Operations,43,71,13.79577376,1,3,3,15,9,0.405521205,1.013803012,114,6
E0295,Finance,40,81,13.19826019,1,14,5,23,5,1.338192127,1.619916785,121,19
E0296,HR,49,66,12.0685369,1,9,8,21,1,1.30083422,1.60691286,115,17
E0297,Engineering,51,71,5.902587281,-1,8,8,12,3,2.317971414,1.738478561,122,16
E0298,Engineering,53,79,9.298136877,0,8,6,11,2,1.359469209,1.068154379,132,14
E0299,HR,57,75,12.01262233,1,7,6,11,9,0.999029993,0.845333071,132,13
E0300,Engineering,54,83,9.128783681,0,4,6,26,2,0.987285376,2.566941976,137,10
E0301,HR,50,63,9.910005055,0,8,4,19,7,1.099907831,1.741520733,113,12
E0302,Marketing,60,78,12.17383513,1,7,8,18,12,1.138620595,1.366344715,138,15
E0303,HR,50,62,13.16817107,1,6,2,18,5,0.564645921,1.270453322,112,8
E0304,Support,50,60,7.232222106,-1,5,7,25,2,1.457686618,3.036847121,110,12
E0305,HR,48,65,12.01012303,1,10,5,22,11,1.152948359,1.690990927,113,15
E0306,Engineering,63,72,11.69488367,1,7,8,14,3,1.181578374,1.102806482,135,15
E0307,Support,45,74,7.03339428,-1,6,5,15,12,1.369284217,1.867205751,119,11
E0308,Engineering,59,88,8.780550199,0,5,4,22,8,0.920193631,2.249362209,147,9
E0309,Sales,59,77,10.44905548,0,6,7,20,2,1.135464845,1.746868992,136,13
E0310,Sales,48,61,14.16984488,1,11,7,23,5,1.186564539,1.5161658,109,18
E0311,Support,52,68,8.755743368,0,11,7,20,5,1.845066985,2.050074428,120,18
E0312,Marketing,51,69,11.25296487,0,7,7,17,8,1.142580604,1.387419305,120,14
E0313,Sales,56,76,13.50629939,1,7,4,20,5,0.758291257,1.378711376,132,11
E0314,HR,46,62,15.56404233,2,9,4,19,3,0.784832575,1.147062995,108,13
E0315,Engineering,51,70,10.68048353,0,9,8,23,3,1.455419201,1.969096566,121,17
E0316,Sales,44,85,3.641003131,-2,7,2,15,4,1.939235925,3.232059875,129,9
E0317,Sales,50,58,12.77024579,1,5,11,21,3,1.16192552,1.525027245,108,16
E0318,Marketing,55,76,10.63321151,0,10,2,19,1,1.031529427,1.633254926,131,12
E0319,Support,52,82,7.465252754,-1,5,4,18,9,1.063169673,2.126339345,134,9
E0320,Support,47,57,12.13319071,1,6,5,22,12,0.837572547,1.675145095,104,11
E0321,Operations,45,51,15.59599413,2,7,4,18,8,0.66281055,1.084599082,96,11
E0322,Marketing,43,67,10.62696778,0,4,4,22,3,0.688055575,1.892152831,110,8
E0323,HR,65,70,5.134564639,-2,11,5,22,1,2.608172045,3.586236562,135,16
E0324,Support,63,55,14.33227629,1,3,5,19,8,0.5217751,1.239215863,118,8
E0325,Engineering,52,73,10.06793331,0,7,3,16,12,0.903511046,1.445617673,125,10
E0326,Marketing,56,67,12.13764589,1,6,5,29,1,0.837288513,2.20739699,123,11
E0327,Sales,52,73,10.18603689,0,10,4,26,3,1.251560328,2.324326323,125,14
E0328,Engineering,50,59,11.36850588,0,12,6,23,11,1.455309168,1.859561714,109,18
E0329,Engineering,64,72,11.99704916,1,14,3,31,2,1.307989206,2.385156787,136,17
E0330,Sales,54,69,12.42084808,1,6,1,12,11,0.521576577,0.894131275,123,7
E0331,Marketing,54,58,10.43998568,0,5,2,17,3,0.611888878,1.486015847,112,7
E0332,Sales,44,50,7.718270295,-1,3,7,31,9,1.147016514,3.555751193,94,10
E0333,Operations,49,75,10.58104105,0,10,7,35,12,1.467916392,3.022180807,124,17
E0334,Engineering,40,73,12.36561171,1,10,3,22,7,0.972645344,1.646015198,113,13
E0335,Finance,45,74,7.73918157,-1,8,4,19,7,1.373126294,2.174116632,119,12
E0336,Finance,57,71,6.680054447,-1,4,6,29,9,1.302074102,3.776014897,128,10
E0337,HR,43,69,13.9990834,1,6,4,16,9,0.666707407,1.066731851,112,10
E0338,Support,49,71,15.07474442,2,5,7,31,2,0.746512647,1.928491004,120,12
E0339,Sales,62,85,10.1151159,0,13,7,18,1,1.799351457,1.619416312,147,20
E0340,Sales,62,80,11.80365956,1,7,5,21,12,0.937232042,1.640156074,142,12
E0341,HR,52,76,11.12734339,0,2,4,18,7,0.494749741,1.484249223,128,6
E0342,HR,35,73,3.460184659,-2,10,8,34,7,4.035707348,7.623002768,108,18
E0343,HR,53,67,10.62018054,0,3,4,15,12,0.602400279,1.290857741,120,7
E0344,Engineering,51,58,14.39791896,1,3,7,12,8,0.64943841,0.779326092,109,10
E0345,Operations,47,62,6.476874941,-1,8,5,19,2,1.738694321,2.541168623,109,13
E0346,Sales,55,64,6.202487231,-1,15,8,19,1,3.193341309,2.637977603,119,23
E0347,Engineering,38,61,7.808953557,-1,9,6,14,3,1.702812928,1.589292066,99,15
E0348,HR,48,83,8.577593315,0,10,4,16,11,1.46174509,1.670565817,131,14
E0349,Sales,46,74,12.00142771,1,9,5,30,11,1.076804818,2.307438896,120,14
E0350,Engineering,52,68,13.96192121,1,9,6,19,12,1.002545047,1.269890392,120,15
E0351,Operations,43,72,13.89154217,1,9,5,21,3,0.940130971,1.410196456,115,14
E0352,Engineering,52,73,11.96184181,1,12,8,15,12,1.542990595,1.157242946,125,20
E0353,Operations,50,68,5.22674054,-2,7,3,28,10,1.605976664,4.496734659,118,10
E0354,HR,62,77,5.214458674,-2,9,8,14,5,2.735556046,2.252810862,139,17
E0355,Operations,49,62,12.2025407,1,10,5,20,8,1.136144955,1.51485994,111,15
E0356,Sales,51,78,5.239038999,-2,7,8,20,1,2.404216419,3.205621892,129,15
E0357,HR,49,69,11.66606478,1,6,3,19,3,0.71056008,1.500071279,118,9
E0358,Sales,45,72,10.83249009,0,7,10,18,6,1.436722099,1.521235164,117,17
E0359,Finance,46,69,8.609617341,0,8,7,17,12,1.560936244,1.769061077,115,15
E0360,Marketing,64,70,2.360853411,-3,9,4,20,4,3.868065163,5.950869482,134,13
E0361,Operations,43,73,10.60534533,0,9,3,16,12,1.034006284,1.378675046,116,12
E0362,Marketing,44,86,11.53557036,0,6,6,15,10,0.957275948,1.196594935,130,12
E0363,Marketing,45,68,8.331679718,-1,11,3,27,9,1.500265807,2.89336977,113,14
E0364,Operations,49,71,6.724193618,-1,4,1,21,2,0.647316762,2.718730399,120,5
E0365,HR,43,64,10.88000577,0,4,5,22,3,0.75757539,1.851850952,107,9
E0366,Finance,53,72,5.643200942,-1,7,7,22,2,2.107417813,3.311656563,125,14
E0367,Sales,42,72,11.85058131,1,7,4,28,2,0.855992405,2.178889759,114,11
E0368,Engineering,56,65,13.16752873,1,4,7,15,11,0.776423342,1.058759102,121,11
E0369,Sales,59,71,4.119583167,-2,6,4,25,10,1.953284022,4.883210055,130,10
E0370,Engineering,47,64,8.415589669,-1,13,6,21,4,2.017929909,2.230343583,111,19
E0371,Sales,46,65,9.853694139,0,11,5,17,12,1.474152468,1.566286997,111,16
E0372,Operations,40,73,9.94180025,0,10,5,15,3,1.370889585,1.370889585,113,15
E0373,Finance,52,71,7.36302097,-1,7,4,22,8,1.315314172,2.630628343,123,11
E0374,Engineering,57,70,5.991213804,-1,3,8,17,6,1.573403462,2.431623532,127,11
E0375,Support,50,69,8.619580335,0,7,3,24,1,1.039546389,2.494911333,119,10
E0376,HR,41,58,11.93235435,1,10,4,19,6,1.08255617,1.469183374,99,14
E0377,Sales,53,58,11.71143412,1,11,2,19,3,1.022701284,1.494717262,111,13
E0378,Sales,48,87,11.74810553,1,12,3,18,3,1.176645421,1.411974505,135,15
E0379,Engineering,33,72,13.75296948,1,12,12,13,4,1.626791137,0.881178533,105,24
E0380,HR,50,75,6.857978179,-1,7,2,15,8,1.145332781,1.908887968,125,9
E0381,HR,48,63,8.8660705,0,7,4,24,7,1.114932232,2.432579414,111,11
E0382,Operations,65,71,9.445489367,0,12,10,27,3,2.106172265,2.58484778,136,22
E0383,Support,45,64,1.352556294,-3,11,6,22,1,7.226182022,9.351529676,109,17
E0384,Operations,39,72,10.67272593,0,8,5,22,6,1.113707293,1.884735419,111,13
E0385,Operations,47,68,9.911000279,0,8,6,15,1,1.283108756,1.374759382,115,14
E0386,Operations,52,66,6.590934853,-1,8,6,17,5,1.844305118,2.239513358,118,14
E0387,Operations,60,69,12.61387872,1,5,4,22,4,0.661090067,1.615997942,129,9
E0388,Operations,54,72,12.42431109,1,4,6,27,6,0.744917183,2.011276394,126,10
E0389,Finance,59,66,11.19948648,0,8,5,19,2,1.065618624,1.557442604,125,13
E0390,HR,59,71,4.873511821,-2,5,7,25,2,2.043070716,4.256397324,130,12
E0391,Operations,55,74,7.080973866,-1,8,6,28,12,1.732464457,3.464928914,129,14
E0392,HR,44,60,10.91210646,0,4,6,20,5,0.839482088,1.678964176,104,10
E0393,HR,57,68,8.389132261,-1,9,6,22,1,1.597591724,2.343134529,125,15
E0394,Marketing,56,56,9.307517256,0,6,8,12,12,1.358232022,1.164198876,112,14
E0395,Finance,41,73,6.696543174,-1,7,3,23,3,1.299284598,2.988354574,114,10
E0396,Operations,51,92,10.57572027,0,4,7,10,10,0.950264843,0.86387713,143,11
E0397,Sales,55,69,14.51437175,1,10,7,26,6,1.095758196,1.675865476,124,17
E0398,Engineering,60,75,10.97121599,0,11,4,28,1,1.253005543,2.338943681,135,15
E0399,Support,42,82,12.91373631,1,10,10,24,11,1.43742842,1.724914104,124,20
E0400,Sales,51,75,12.63283901,1,11,4,26,11,1.100284393,1.907159615,126,15
E0401,Finance,58,69,8.925428498,0,4,8,26,2,1.209015812,2.61953426,127,12
E0402,Engineering,62,76,9.443316013,0,7,4,27,2,1.05330529,2.585385712,138,11
E0403,Finance,43,56,14.4121089,1,9,2,23,10,0.713724518,1.492333084,99,11
E0404,HR,52,84,12.19761711,1,6,6,19,9,0.90925505,1.439653829,136,12
E0405,Engineering,56,57,12.88261196,1,8,7,17,7,1.080488315,1.224553423,113,15
E0406,HR,43,71,10.49981004,0,9,2,21,2,0.956537539,1.82611712,114,11
E0407,Sales,54,70,8.82413115,0,11,1,27,1,1.221482065,2.748334645,124,12
E0408,Sales,48,73,9.189253129,0,9,6,23,1,1.472139303,2.257280265,121,15
E0409,Engineering,64,67,14.13184087,1,2,6,22,11,0.528686501,1.453887877,131,8
E0410,Engineering,44,66,9.997569326,0,12,6,16,9,1.636725304,1.454866937,110,18
E0411,Operations,52,66,13.74294727,1,6,5,25,5,0.74611947,1.695726067,118,11
E0412,Finance,63,81,14.2154067,1,12,9,24,8,1.380179998,1.57734857,144,21
E0413,Operations,44,75,12.76182728,1,6,8,19,5,1.017306766,1.380630611,119,14
E0414,Finance,50,73,12.41094004,1,9,4,13,2,0.96935785,0.96935785,123,13
E0415,Operations,53,75,15.0907136,2,11,8,26,11,1.180805306,1.61583884,128,19
E0416,HR,33,74,7.463162698,-1,12,3,20,12,1.772387054,2.363182738,107,15
E0417,Engineering,49,79,8.763147243,0,5,4,14,1,0.92183389,1.433963829,128,9
E0418,Sales,69,75,6.22192442,-1,13,10,18,12,3.184746705,2.492410465,144,23
E0419,Finance,55,61,5.507665299,-2,10,4,23,7,2.151309165,3.534293628,116,14
E0420,Finance,51,72,9.867053787,0,4,2,23,7,0.55212757,2.116489018,123,6
E0421,Sales,44,66,10.80571453,0,5,4,16,9,0.762342676,1.355275868,110,9
E0422,Operations,51,83,11.51608054,0,4,2,20,6,0.479383301,1.597944335,134,6
E0423,Finance,61,75,7.908154213,-1,14,5,31,6,2.132877311,3.479957717,136,19
E0424,Support,44,84,8.760845415,0,4,8,22,1,1.229401705,2.253903127,128,12
E0425,HR,54,62,12.5402172,1,5,3,22,11,0.590832472,1.624789299,116,8
E0426,Engineering,45,74,5.618478797,-1,6,4,21,2,1.510921211,3.172934544,119,10
E0427,Sales,58,59,10.03802802,0,10,8,21,3,1.630726065,1.902513743,117,18
E0428,Engineering,49,78,13.9178242,1,7,8,25,12,1.005508565,1.675847608,127,15
E0429,Support,46,77,9.203188449,0,8,5,30,12,1.274111525,2.940257367,123,13
E0430,Finance,39,61,8.736515281,0,10,3,15,1,1.335179951,1.540592252,100,13
E0431,Finance,48,70,13.72850201,1,8,3,23,10,0.746851241,1.561598049,118,11
E0432,Support,60,73,5.758799058,-1,14,5,15,5,2.8111503,2.219329184,133,19
E0433,Sales,44,70,7.587914385,-1,5,7,16,10,1.397312486,1.863083315,114,12
E0434,HR,56,54,7.703182703,-1,9,8,22,8,1.953308414,2.527810888,110,17
E0435,Marketing,49,69,12.08264446,1,11,3,15,6,1.070120039,1.146557184,118,14
E0436,Sales,51,66,5.18782997,-2,11,2,20,8,2.100898063,3.232150866,117,13
E0437,Marketing,61,49,13.70085103,1,5,4,18,8,0.612209455,1.22441891,110,9
E0438,Support,60,64,9.920165834,0,7,6,26,9,1.190458112,2.380916224,124,13
E0439,Operations,58,71,13.13738706,1,6,8,14,8,0.990282005,0.990282005,129,14
E0440,Marketing,54,68,13.72247521,1,5,3,24,5,0.543386889,1.630160667,122,8
E0441,HR,44,67,7.643201849,-1,10,4,17,6,1.619770109,1.966863704,111,14
E0442,Operations,49,58,10.05501307,0,3,4,18,6,0.6331969,1.628220599,107,7
E0443,Marketing,47,86,9.315783703,0,5,1,22,9,0.581632978,2.132654254,133,6
E0444,Support,49,68,9.803664101,0,11,3,13,6,1.295856653,1.203295463,117,14
E0445,Operations,49,57,8.291201029,-1,9,5,17,3,1.506801969,1.829688105,106,14
E0446,Support,46,50,13.34249695,1,9,6,15,4,1.045842998,1.045842998,96,15
E0447,Marketing,48,83,9.441817304,0,12,4,19,10,1.53230032,1.81960663,131,16
E0448,Support,62,69,8.997608771,0,8,5,18,3,1.300310934,1.800430524,131,13
E0449,HR,41,79,13.37064023,1,6,3,12,8,0.626276899,0.835035865,120,9
E0450,Marketing,49,68,12.50851714,1,10,1,20,7,0.814301073,1.480547406,117,11
E0451,Marketing,55,66,10.86263603,0,5,6,24,8,0.927281253,2.023159098,121,11
E0452,Marketing,47,82,8.82283726,0,6,7,21,6,1.323446542,2.137875182,129,13
E0453,Sales,35,67,14.39383205,1,7,6,24,11,0.844494078,1.559065989,102,13
E0454,Sales,46,64,6.829452237,-1,9,7,16,3,2.043565695,2.043565695,110,16
E0455,Sales,44,70,13.21714948,1,5,6,16,5,0.773713466,1.125401405,114,11
E0456,HR,65,59,11.87935925,1,8,4,10,3,0.93172337,0.776436142,124,12
E0457,Operations,45,66,6.200790525,-1,7,7,13,10,1.944230977,1.805357336,111,14
E0458,Support,45,72,10.22171554,0,14,5,18,5,1.693145752,1.604032818,117,19
E0459,Finance,63,76,6.037767152,-1,5,7,20,9,1.70508625,2.841810416,139,12
E0460,Marketing,48,68,8.956295671,0,7,8,19,5,1.506584426,1.908340273,116,15
E0461,Support,59,71,10.84047786,0,12,5,13,6,1.435752864,1.09792866,130,17
E0462,Marketing,65,67,6.957089471,-1,9,7,20,7,2.010785484,2.513481855,132,16
E0463,HR,46,70,2.956660877,-2,8,5,15,12,3.285598742,3.791075472,116,13
E0464,Marketing,54,52,9.616738911,0,7,3,24,1,0.941908818,2.260581164,106,10
E0465,Sales,51,63,10.64366843,0,8,8,18,8,1.374137378,1.54590455,114,16
E0466,Finance,36,90,8.86907355,0,7,2,25,2,0.911939703,2.533165841,126,9
E0467,Engineering,51,72,9.953831628,0,6,4,18,8,0.912922559,1.643260606,123,10
E0468,Marketing,41,58,9.46115574,0,7,2,22,11,0.860325592,2.103018113,99,9
E0469,Support,43,73,6.946997861,-1,8,2,16,4,1.258336818,2.013338909,116,10
E0470,Sales,48,65,15.84135405,2,5,4,22,1,0.534398836,1.306308266,113,9
E0471,Engineering,44,71,10.95096265,0,10,7,32,7,1.422479552,2.677608568,115,17
E0472,Finance,45,51,8.722510541,0,5,3,17,9,0.822832741,1.748519575,96,8
E0473,Engineering,38,70,7.52564803,-1,7,7,18,9,1.642103914,2.111276461,108,14
E0474,Sales,45,59,8.807306641,0,11,7,23,4,1.83536629,2.345190259,104,18
E0475,Operations,46,72,8.905119452,0,4,5,19,12,0.908621046,1.918199987,118,9
E0476,Operations,59,76,10.11445883,0,11,5,23,8,1.439566266,2.069376507,135,16
E0477,Engineering,55,66,13.43861868,1,10,5,19,7,1.038880542,1.315915353,121,15
E0478,HR,54,64,7.586290456,-1,13,8,22,4,2.445759331,2.562224061,118,21
E0479,Support,44,59,10.53317217,0,6,6,13,8,1.040476967,1.127183381,103,12
E0480,Support,46,86,12.39891302,1,5,8,9,1,0.970227957,0.671696278,132,13
E0481,Engineering,51,51,7.978457658,-1,9,8,31,9,1.893420969,3.452708826,102,17
E0482,Marketing,47,59,7.961212699,-1,6,6,22,12,1.339104472,2.455024865,106,12
E0483,Marketing,40,56,5.472685271,-2,10,6,18,4,2.471926153,2.780916922,96,16
E0484,Support,58,84,15.04363282,2,12,3,15,1,0.934950343,0.934950343,142,15
E0485,Support,46,68,11.52377666,0,9,5,21,12,1.117873656,1.676810484,114,14
E0486,Operations,47,63,8.288858057,-1,12,8,16,12,2.153117194,1.722493756,110,20
E0487,HR,46,77,8.158943899,-1,4,6,16,9,1.091828939,1.746926302,123,10
E0488,Sales,40,65,6.905853505,-1,9,7,14,2,2.023816909,1.770839795,105,16
E0489,Marketing,59,63,10.47130109,0,5,5,24,2,0.871740696,2.09217767,122,10
E0490,Support,41,67,8.973548112,0,15,5,15,12,2.005304409,1.503978307,108,20
E0491,Operations,39,68,7.247844465,-1,4,3,19,11,0.848706596,2.303632189,107,7
E0492,Finance,53,65,7.684786199,-1,7,7,22,2,1.612014352,2.533165411,118,14
E0493,Operations,38,54,12.17715289,1,11,3,23,8,1.062444985,1.745445332,92,14
E0494,Marketing,49,80,8.855695972,0,5,8,21,6,1.319034195,2.130747545,129,13
E0495,Marketing,40,76,6.315836463,-1,7,6,16,8,1.776967004,2.187036312,116,13
E0496,Operations,47,65,10.19403799,0,8,3,22,12,0.982665952,1.965331904,112,11
E0497,Sales,50,75,7.94127375,-1,13,3,32,3,1.789454215,3.57890843,125,16
E0498,Engineering,49,70,11.93821745,1,8,6,19,9,1.082065598,1.468517597,119,14
E0499,Marketing,52,70,14.52082565,1,11,5,29,3,1.030872994,1.868457301,122,16
E0500,Operations,50,88,4.187656081,-2,7,6,16,4,2.505948698,3.084244551,138,13
E0501,Support,45,73,7.879177634,-1,3,6,16,2,1.013607382,1.80196868,118,9
E0502,Operations,39,82,10.41554935,0,3,5,19,2,0.700798512,1.664396467,121,8
E0503,HR,50,63,9.770641778,0,6,3,20,9,0.835604803,1.856899562,113,9
E0504,Engineering,49,71,13.7555534,1,4,4,15,2,0.542168754,1.016566414,120,8
E0505,Finance,43,62,9.942095574,0,6,5,20,6,1.005291895,1.827803446,105,11
E0506,Sales,56,78,10.61304829,0,6,6,25,5,1.033320425,2.152750886,134,12
E0507,Finance,52,80,11.29248931,0,8,6,18,10,1.138906827,1.464308778,132,14
E0508,Engineering,36,74,7.957470133,-1,7,7,23,3,1.562941298,2.567689276,110,14
E0509,Engineering,41,69,11.54559099,1,5,9,17,10,1.115929892,1.355057726,110,14
E0510,Engineering,56,63,11.21672585,0,6,1,17,6,0.572984946,1.391534869,119,7
E0511,Finance,41,73,10.30958331,0,5,8,20,3,1.149467637,1.768411749,114,13
E0512,Support,49,79,4.246709201,-2,7,5,19,9,2.287147913,3.621317529,128,12
E0513,Engineering,46,68,7.716992008,-1,13,4,13,6,1.950214017,1.491340131,114,17
E0514,Operations,53,74,10.55717322,0,9,6,22,5,1.297895231,1.903579672,127,15
E0515,Finance,53,60,9.714634976,0,7,9,17,7,1.493284656,1.586614947,113,16
E0516,Engineering,40,54,12.24695125,1,5,5,24,6,0.754890677,1.811737625,94,10
E0517,Operations,43,81,12.27092424,1,8,8,15,12,1.205643233,1.130290531,124,16
E0518,Support,48,67,11.03377308,0,8,6,14,11,1.163392388,1.163392388,115,14
E0519,HR,50,45,12.27138442,1,7,2,14,9,0.678150803,1.054901249,95,9
E0520,Support,54,71,11.50028219,0,10,5,21,7,1.19997291,1.679962075,125,15
E0521,Engineering,50,76,8.421100753,-1,10,6,19,1,1.698315348,2.016749475,126,16
E0522,Finance,57,64,9.98252168,0,5,1,21,12,0.546322618,1.912129164,121,6
E0523,Marketing,57,64,6.703428963,-1,11,6,17,4,2.206809472,2.206809472,121,17
E0524,Engineering,42,66,14.48018229,1,9,5,14,5,0.904382115,0.904382115,108,14
E0525,Marketing,47,79,6.236597541,-1,6,4,17,11,1.381864881,2.349170298,126,10
E0526,Operations,58,68,3.747663373,-2,14,6,25,2,4.212598583,5.265748229,126,20
E0527,HR,52,73,16.36199405,2,7,6,16,4,0.74876192,0.921553133,125,13
E0528,Sales,58,64,9.72143719,0,6,4,18,1,0.932710776,1.678879397,122,10
E0529,Support,52,66,12.68426373,1,12,5,22,9,1.242302862,1.607686057,118,17
E0530,HR,56,56,12.19881771,1,8,4,27,4,0.909172341,2.045637768,112,12
E0531,Engineering,62,82,13.13619463,1,9,3,21,9,0.848884747,1.485548307,144,12
E0532,Marketing,41,71,11.77340004,1,9,7,17,3,1.252603062,1.330890753,112,16
E0533,Support,61,68,11.79215027,1,8,1,21,5,0.703556463,1.641631747,129,9
E0534,Marketing,41,67,2.97998087,-2,8,4,20,6,3.015089869,5.025149781,108,12
E0535,Finance,49,60,7.109141028,-1,8,6,19,5,1.726446729,2.343034846,109,14
E0536,Marketing,46,60,2.116459017,-3,5,2,24,2,2.246138955,7.701047846,106,7
E0537,Finance,53,75,7.540237599,-1,10,2,17,10,1.405113132,1.990576937,128,12
E0538,Operations,46,81,8.400853299,-1,5,3,21,8,0.85098658,2.233839773,127,8
E0539,Support,51,66,9.650263464,0,6,1,18,1,0.657260736,1.690099035,117,7
E0540,Support,39,68,7.15680151,-1,7,3,24,1,1.225970742,2.942329781,107,10
E0541,Sales,60,60,8.942717104,0,9,6,17,4,1.508641938,1.709794196,120,15
E0542,Engineering,61,72,8.446324593,-1,15,2,24,8,1.799641737,2.540670688,133,17
E0543,Finance,57,58,11.03624287,0,7,6,16,6,1.08007126,1.329318474,115,13
E0544,Sales,44,61,12.27737662,1,4,6,22,8,0.75316083,1.656953826,105,10
E0545,Marketing,50,68,10.64262282,0,9,3,20,10,1.030695591,1.717825984,118,12
E0546,Marketing,38,77,11.89093253,1,7,5,20,6,0.930886883,1.551478138,115,12
E0547,Sales,38,75,10.57251965,0,7,2,20,10,0.777704448,1.728232106,113,9
E0548,Support,60,53,13.56100801,1,9,6,19,11,1.030148462,1.304854718,113,15
E0549,Marketing,46,69,15.5924407,2,5,4,25,6,0.54241568,1.506710222,115,9
E0550,Operations,46,67,2.66122546,-2,6,4,26,5,2.73132592,7.101447393,113,10
E0551,Operations,59,63,13.39961415,1,11,9,26,9,1.388926105,1.805603937,122,20
E0552,Sales,54,63,6.131197676,-1,8,4,25,7,1.68274679,3.50572248,117,12
E0553,Finance,55,71,10.55739588,0,5,2,23,12,0.605672772,1.99006768,126,7
E0554,Finance,40,76,10.7840657,0,12,1,20,2,1.103184616,1.697207102,116,13
E0555,Sales,45,60,11.82530838,1,7,6,13,12,1.013620852,1.013620852,105,13
E0556,Finance,39,69,9.847193694,0,11,2,22,2,1.19846666,2.028174348,108,13
E0557,Support,54,75,9.985357767,0,10,7,25,3,1.547514461,2.27575656,129,17
E0558,Support,46,60,11.03018929,0,4,6,13,10,0.831242116,1.080614751,106,10
E0559,Finance,57,93,8.961574514,0,5,3,13,9,0.803085897,1.305014582,150,8
E0560,Operations,44,66,4.301634245,-2,4,5,22,6,1.697589759,4.149663855,110,9
E0561,Finance,50,60,9.994739035,0,9,6,19,7,1.364288861,1.728099224,110,15
E0562,Support,46,94,7.753514123,-1,12,5,18,1,1.942077177,2.056317011,140,17
E0563,HR,56,75,7.497148959,-1,9,3,21,3,1.412238394,2.47141719,131,12
E0564,Engineering,49,67,7.205297111,-1,14,5,22,7,2.315577333,2.681194807,116,19
E0565,Marketing,34,68,4.086238873,-2,8,6,18,12,2.752525068,3.538960802,102,14
E0566,HR,63,71,8.800985622,0,9,7,21,6,1.632488876,2.142641649,134,16
E0567,Finance,45,66,10.00239481,0,4,6,15,11,0.908893034,1.363339551,111,10
E0568,Operations,52,73,12.30403123,1,10,4,21,9,1.052312623,1.578468935,125,14
E0569,Sales,51,68,8.227813525,-1,9,7,15,6,1.733888527,1.625520494,119,16
E0570,Finance,60,71,14.73254845,2,10,4,21,3,0.889874901,1.334812352,131,14
E0571,Operations,54,64,11.75127276,1,11,3,20,8,1.097929615,1.568470879,118,14
E0572,Engineering,51,79,6.636742124,-1,5,5,16,11,1.309458908,2.095134252,130,10
E0573,Finance,62,75,8.535146971,0,12,4,18,9,1.678002452,1.887752759,137,16
E0574,Support,58,61,16.06463093,2,16,6,20,2,1.289216279,1.172014799,119,22
E0575,Sales,63,82,12.27985726,1,6,9,23,2,1.129530213,1.731946327,145,15
E0576,Operations,46,64,8.419346994,-1,10,8,15,5,1.910960496,1.59246708,110,18
E0577,Operations,51,67,12.67796847,1,6,5,17,11,0.804212996,1.24287463,118,11
E0578,Operations,46,66,6.216350795,-1,12,5,23,6,2.35576131,3.187206478,112,17
E0579,Engineering,47,74,8.341968445,-1,8,3,22,7,1.177482033,2.354964067,121,11
E0580,Finance,49,77,3.010165876,-2,6,8,20,7,3.491127408,4.987324869,126,14
E0581,Engineering,42,60,11.81111468,1,5,3,16,5,0.624457762,1.248915523,102,8
E0582,Marketing,50,72,6.503324406,-1,9,3,22,11,1.599291108,2.932033697,122,12
E0583,Marketing,59,64,9.758267094,0,13,6,19,9,1.766083686,1.766083686,123,19
E0584,Finance,87,71,5.3606934,-2,4,7,21,3,1.729371204,3.301526843,158,11
E0585,Support,52,73,10.60124774,0,6,6,25,2,1.034371498,2.154940621,125,12
E0586,Engineering,49,63,9.777529926,0,6,5,25,1,1.020642028,2.319640973,112,11
E0587,Sales,49,72,5.578489024,-1,7,6,21,9,1.976137674,3.192222397,121,13
E0588,Operations,55,63,8.567985324,0,9,1,19,5,1.045152105,1.985788999,118,10
E0589,Operations,43,58,10.39959177,0,9,6,19,3,1.315836594,1.666726352,101,15
E0590,Finance,45,72,11.33554163,0,10,5,18,2,1.215998491,1.459198189,117,15
E0591,Support,40,70,14.74990496,2,13,0,13,6,0.825401806,0.825401806,110,13
E0592,Marketing,46,75,13.65362441,1,8,4,20,2,0.81891003,1.364850049,121,12
E0593,Marketing,54,72,7.91484765,-1,10,4,20,3,1.570413825,2.243448322,126,14
E0594,Operations,52,68,7.878256659,-1,2,6,26,11,0.901077802,2.928502858,120,8
E0595,Finance,43,89,5.708081009,-1,12,7,21,4,2.832404673,3.130552534,132,19
E0596,Engineering,47,69,6.97078296,-1,9,9,19,10,2.258247413,2.383705603,116,18
E0597,Marketing,40,73,12.58046623,1,6,5,17,3,0.809986919,1.251797966,113,11
E0598,Engineering,46,79,5.232650745,-2,10,8,14,10,2.88801679,2.246235281,125,18
E0599,Support,54,61,9.535215389,0,7,2,24,12,0.854277741,2.278073975,115,9
E0600,Marketing,41,73,9.095349874,0,5,6,20,4,1.089610577,1.98111014,114,11
E0601,Marketing,60,53,7.726498151,-1,6,6,18,11,1.375122047,2.06268307,113,12
E0602,HR,59,67,6.093046263,-1,5,4,21,12,1.268848343,2.960646134,126,9
E0603,Marketing,52,80,4.316946414,-2,8,3,26,2,2.06885666,4.890024833,132,11
E0604,Sales,46,72,6.120020324,-1,10,2,23,9,1.685388448,3.230327858,118,12
E0605,Finance,50,68,9.750687739,0,13,3,32,9,1.488276879,2.976553759,118,16
E0606,Finance,46,66,11.79297202,1,9,4,23,1,1.016182947,1.797862136,112,13
E0607,Engineering,62,65,14.83579452,2,11,6,25,1,1.07351734,1.57870197,127,17
E0608,Support,46,65,11.00345003,0,11,5,24,8,1.332950107,1.999425161,111,16
E0609,Marketing,54,75,11.77832909,1,10,5,20,11,1.173862396,1.565149861,129,15
E0610,Sales,48,72,14.82464814,2,7,5,16,5,0.7583107,1.011080933,120,12
E0611,Engineering,57,67,11.01498763,0,7,2,17,12,0.749064442,1.414899501,124,9
E0612,HR,41,54,12.94923643,1,10,9,27,12,1.362081723,1.935589817,95,19
E0613,Engineering,52,79,8.861224346,0,6,2,15,11,0.81125829,1.521109294,131,8
E0614,Engineering,59,72,12.16375327,1,6,3,21,8,0.683695586,1.5952897,131,9
E0615,Marketing,44,64,10.62999246,0,6,9,24,5,1.289768678,2.063629885,108,15
E0616,HR,47,56,9.274468025,0,11,8,17,10,1.849244161,1.654586881,103,19
E0617,Engineering,41,82,14.64160665,2,8,2,21,4,0.639320514,1.342573079,123,10
E0618,Sales,49,73,6.390725714,-1,7,8,30,5,2.029570651,4.059141303,122,15
E0619,Sales,61,75,7.420266413,-1,5,1,20,4,0.712566528,2.375221759,136,6
E0620,Finance,43,72,13.53281403,1,11,7,18,7,1.238576367,1.238576367,115,18
E0621,HR,43,78,12.91344717,1,10,6,16,6,1.149966633,1.149966633,121,16
E0622,HR,50,59,10.03809129,0,8,4,19,8,1.087144479,1.721312091,109,12
E0623,Finance,44,76,11.01908107,0,8,3,18,10,0.915211399,1.497618653,120,11
E0624,Engineering,49,63,11.55215204,1,3,7,20,4,0.796676137,1.593352274,112,10
E0625,HR,59,57,11.09504683,0,4,9,15,7,1.074820146,1.240177091,116,13
E0626,Sales,48,74,10.7234683,0,14,5,24,12,1.620680801,2.047175749,122,19
E0627,Sales,49,65,7.47858676,-1,11,4,13,5,1.769162766,1.533274397,114,15
E0628,Marketing,57,67,13.71469591,1,6,5,21,1,0.747551976,1.427144681,124,11
E0629,HR,56,63,9.387845808,0,10,3,19,3,1.25146255,1.82906065,119,13
E0630,Engineering,58,75,7.028268605,-1,8,3,10,1,1.370158441,1.245598583,133,11
E0631,Finance,47,80,10.40229088,0,10,4,11,3,1.227823439,0.964718417,127,14
E0632,Finance,55,70,11.02963929,0,10,7,22,1,1.413176205,1.828816265,125,17
E0633,Engineering,52,65,11.18606481,0,7,10,33,4,1.395036074,2.708011202,117,17
E0634,Support,60,70,12.91835591,1,8,5,17,5,0.934018363,1.221408628,130,13
E0635,Operations,43,62,8.86057486,0,6,5,15,3,1.115553622,1.521209485,105,11
E0636,Marketing,51,77,9.804529312,0,10,7,18,1,1.573414214,1.665967992,128,17
E0637,Finance,45,81,7.468141535,-1,10,5,23,6,1.77134498,2.716062303,126,15
E0638,HR,62,71,10.70115521,0,4,7,21,10,0.940078121,1.794694594,133,11
E0639,Marketing,50,57,7.424051113,-1,7,1,25,11,0.949661854,2.967693294,107,8
E0640,HR,46,65,8.230250025,-1,10,10,29,8,2.166788543,3.141843387,111,20
E0641,Support,49,77,12.95035417,1,13,4,20,10,1.218607054,1.433655358,126,17
E0642,Sales,57,61,10.40943947,0,8,8,14,6,1.402347595,1.227054145,118,16
E0643,Marketing,54,73,14.27369782,1,8,7,17,5,0.982080448,1.113024508,127,15
E0644,Finance,36,69,13.53015258,1,9,3,22,5,0.825868822,1.514092841,105,12
E0645,Marketing,55,61,10.64723157,0,11,6,26,2,1.459574312,2.232290124,116,17
E0646,Marketing,63,68,11.06113313,0,7,7,23,9,1.160753293,1.906951839,131,14
E0647,Marketing,45,70,9.284512725,0,8,3,19,10,1.06956939,1.847438037,115,11
E0648,Operations,42,68,13.13172222,1,12,3,27,7,1.061441752,1.910595154,110,15
E0649,Marketing,46,84,11.08937336,0,8,6,13,11,1.158041826,1.075324552,130,14
E0650,HR,48,64,12.7286828,1,6,5,18,5,0.801242199,1.311123599,112,11
E0651,Sales,52,67,8.059406429,-1,6,6,19,2,1.324590093,2.097267647,119,12
E0652,Support,69,67,5.9167798,-1,9,7,19,6,2.313215176,2.746943021,136,16
E0653,Engineering,50,67,11.50676379,0,12,3,18,10,1.199351028,1.439221233,117,15
E0654,Marketing,43,62,12.10837933,1,10,8,17,8,1.373167464,1.296880383,105,18
E0655,Finance,40,84,10.22556873,0,5,4,16,2,0.801741116,1.425317539,124,9
E0656,Marketing,56,68,11.73584919,1,7,3,21,5,0.785185177,1.648888871,124,10
E0657,Finance,53,69,7.444000237,-1,11,4,12,7,1.776409235,1.421127388,122,15
E0658,HR,58,70,12.81789401,1,4,10,23,3,1.013178997,1.664508353,128,14
E0659,Finance,55,71,13.51515613,1,9,3,20,4,0.826722075,1.377870125,126,12
E0660,Engineering,53,66,13.06204535,1,5,4,19,11,0.640020692,1.351154795,119,9
E0661,Sales,52,72,10.3719057,0,6,2,21,9,0.703488071,1.846656186,124,8
E0662,Finance,43,80,13.55948212,1,10,7,17,7,1.167623948,1.167623948,123,17
E0663,Finance,45,60,6.571395629,-1,6,10,14,10,2.113216741,1.849064649,105,16
E0664,Sales,47,93,11.72041641,1,6,8,14,4,1.100592901,1.100592901,140,14
E0665,Engineering,37,83,12.14935028,1,10,7,22,5,1.292839543,1.673086467,120,17
E0666,Marketing,53,67,11.50372514,0,8,3,16,7,0.879737828,1.279618659,120,11
E0667,Finance,54,65,7.178890157,-1,10,12,17,2,2.689851505,2.078521618,119,22
E0668,Sales,51,71,10.68807418,0,9,4,27,9,1.112244823,2.310046941,122,13
E0669,HR,53,64,9.231693979,0,5,5,21,4,0.977355267,2.052446061,117,10
E0670,Sales,55,60,4.127801897,-2,10,7,15,12,3.315260679,2.925230011,115,17
E0671,HR,49,65,6.466858239,-1,5,5,23,12,1.339251353,3.080278112,114,10
E0672,Engineering,48,67,13.48377452,1,5,1,19,8,0.414256656,1.311812744,115,6
E0673,Marketing,46,77,8.806256744,0,8,4,17,6,1.223708527,1.733587081,123,12
E0674,Sales,54,70,13.1683916,1,13,2,14,12,1.058694623,0.988114982,124,15
E0675,Support,64,63,13.43095243,1,7,10,20,11,1.178023424,1.385909911,127,17
E0676,Support,44,71,11.63872228,1,8,0,19,9,0.632975377,1.503316521,115,8
E0677,Operations,43,68,8.156706608,-1,6,4,26,8,1.092095709,2.839448845,111,10
E0678,Finance,44,79,12.83270374,1,8,2,22,6,0.722924468,1.590433831,123,10
E0679,Engineering,58,72,10.64066897,0,15,8,15,5,1.975831463,1.288585737,130,23
E0680,Sales,49,87,10.1340038,0,8,6,23,6,1.257409307,2.065743861,136,14
E0681,Support,54,85,7.265179149,-1,9,4,25,8,1.572863669,3.024737825,139,13
E0682,Finance,55,65,8.497652954,-1,5,6,17,4,1.158180874,1.789915896,120,11
E0683,Support,43,70,7.308834714,-1,7,5,16,10,1.444245843,1.925661125,113,12
E0684,Sales,41,66,12.87739051,1,6,2,14,12,0.576477256,1.008835198,107,8
E0685,HR,46,54,14.60310781,2,6,10,16,5,1.025436739,1.025436739,100,16
E0686,Sales,36,60,12.7710563,1,15,7,17,5,1.597553559,1.234473205,96,22
E0687,Operations,43,79,10.59676863,0,5,7,21,4,1.034771011,1.810849269,122,12
E0688,Sales,48,73,9.079486722,0,8,4,20,4,1.190536813,1.984228022,121,12
E0689,Sales,44,76,11.42924856,0,6,8,26,8,1.126375415,2.091840056,120,14
E0690,Operations,46,84,8.748771959,0,18,6,23,11,2.461848539,2.359271516,130,24
E0691,Engineering,41,64,9.905914385,0,8,8,21,7,1.467093857,1.925560687,105,16
E0692,Sales,36,60,7.535596206,-1,10,4,19,5,1.640190054,2.225972216,96,14
E0693,Operations,55,72,11.95192253,1,6,4,24,5,0.77208615,1.85300676,127,10
E0694,Finance,40,66,12.10272476,1,9,3,23,12,0.915840042,1.755360081,106,12
E0695,HR,53,81,12.72656691,1,5,4,16,5,0.655662851,1.165622847,134,9
E0696,HR,50,71,11.67335683,1,4,5,21,7,0.710151235,1.657019548,121,9
E0697,Sales,52,76,11.46391042,0,5,2,13,8,0.561621495,1.043011347,128,7
E0698,Engineering,53,56,6.868533902,-1,6,2,23,6,1.016707826,2.923035001,109,8
E0699,Engineering,52,61,6.742969808,-1,5,6,21,12,1.420643535,2.712137658,113,11
E0700,Finance,45,80,10.99316858,0,8,6,17,1,1.167331211,1.417473613,125,14
E0701,Sales,42,82,13.30269369,1,9,7,19,11,1.118670395,1.328421094,124,16
E0702,HR,57,85,9.198305395,0,12,9,19,1,2.059165634,1.863054622,142,21
E0703,Engineering,49,76,10.01682635,0,8,3,22,2,0.998472668,1.996945336,125,11
E0704,Sales,52,76,10.04798824,0,9,4,22,6,1.176684816,1.991312765,128,13
E0705,Support,58,70,4.470134985,-2,9,4,16,9,2.376540988,2.924973523,128,13
E0706,Engineering,55,55,10.72127326,0,10,5,23,8,1.279724452,1.96224416,110,15
E0707,Operations,55,89,8.350443916,-1,11,4,30,3,1.604201911,3.208403822,144,15
E0708,Support,52,72,11.83324129,1,8,7,26,6,1.168839552,2.025988556,124,15
E0709,Engineering,59,74,9.90598813,0,8,3,26,2,1.008620207,2.384011397,133,11
E0710,HR,45,61,9.462212393,0,8,4,12,6,1.146984935,1.146984935,106,12
E0711,Marketing,46,67,9.527562883,0,7,6,19,5,1.234853702,1.80478618,113,13
E0712,Support,54,78,9.018941064,0,5,5,21,8,0.998109474,2.096029896,132,10
E0713,Finance,57,71,5.915354975,-1,9,4,19,11,1.879874576,2.747508995,128,13
E0714,Finance,55,72,12.86004568,1,6,3,18,10,0.649348509,1.298697018,127,9
E0715,HR,41,71,8.09828816,-1,11,6,23,7,1.868483357,2.527948071,112,17
E0716,Engineering,46,62,8.596743269,0,5,3,28,2,0.833616132,2.917656461,108,8
E0717,Sales,41,69,10.23719636,0,15,3,17,8,1.601823036,1.512832868,110,18
E0718,Engineering,61,64,6.653341033,-1,8,10,15,2,2.35191401,1.959928342,125,18
E0719,HR,43,63,8.502760724,-1,7,7,17,6,1.473256079,1.78895381,106,14
E0720,Finance,47,59,15.74947906,2,5,4,17,4,0.537330144,1.014956939,106,9
E0721,Engineering,52,65,11.01020309,0,16,10,22,7,2.164826006,1.831775852,117,26
E0722,Finance,38,68,7.426591522,-1,16,6,25,8,2.610782775,2.966798608,106,22
E0723,Support,47,70,3.755980854,-2,9,5,26,1,2.943661976,5.466800813,117,14
E0724,Sales,41,82,13.00418273,1,8,5,20,4,0.928294086,1.428144747,123,13
E0725,Support,46,73,6.963750162,-1,7,4,14,12,1.381258801,1.757965747,119,11
E0726,Finance,48,79,8.37139072,-1,8,4,29,8,1.280492977,3.094524694,127,12
E0727,Finance,55,69,8.751297154,0,7,3,21,11,1.025504591,2.153559641,124,10
E0728,Marketing,41,67,7.260612081,-1,5,4,16,7,1.089507643,1.936902477,108,9
E0729,Marketing,46,63,9.77129106,0,8,5,15,1,1.20691196,1.392590723,109,13
E0730,Support,48,71,8.345766454,-1,4,5,16,4,0.963002879,1.712005118,119,9
E0731,Operations,50,71,11.8334013,1,7,8,22,4,1.168824978,1.714276635,121,15
E0732,Support,57,71,10.42165509,0,12,6,27,12,1.575953735,2.363930602,128,18
E0733,Marketing,57,59,14.29638562,1,8,9,25,12,1.111373655,1.634373023,116,17
E0734,Finance,56,84,14.35705552,1,9,8,20,11,1.106983039,1.302332987,140,17
E0735,HR,53,55,7.135549332,-1,11,6,15,6,2.089594606,1.843759946,108,17
E0736,Support,61,62,9.01895439,0,9,8,22,7,1.69678385,2.195837923,123,17
E0737,Finance,57,57,16.46291724,2,10,4,32,7,0.801698812,1.832454427,114,14
E0738,HR,52,69,6.524621521,-1,5,6,16,8,1.461867546,2.126352795,121,11
E0739,HR,51,49,12.39287586,1,7,3,36,6,0.746665623,2.687996244,100,10
E0740,Marketing,59,89,11.64399365,1,8,4,22,12,0.949067228,1.739956585,148,12
E0741,Support,45,63,7.453150836,-1,6,10,13,1,1.892785342,1.537888091,108,16
E0742,Engineering,39,65,7.597903565,-1,9,4,18,8,1.511996489,2.0935336,104,13
E0743,Sales,46,61,15.53483159,2,5,3,16,7,0.483827123,0.967654247,107,8
E0744,Marketing,54,64,15.47485787,2,3,3,20,7,0.364191306,1.213971019,118,6
E0745,Marketing,44,73,11.28974692,0,8,5,18,2,1.057792327,1.46463553,117,13
E0746,Engineering,36,69,5.841387022,-1,7,5,27,1,1.754030281,3.946568132,105,12
E0747,Sales,38,80,13.77057361,1,11,5,22,1,1.083234844,1.489447911,118,16
E0748,Finance,59,73,5.828694116,-1,11,2,20,9,1.903731487,2.928817672,132,13
E0749,Operations,56,70,12.14559708,1,7,9,17,4,1.217137564,1.293208662,126,16
E0750,Support,38,75,5.142213178,-2,7,6,23,5,2.116500946,3.744578597,113,13
E0751,Operations,53,53,10.02285551,0,7,6,11,11,1.179367723,0.997926535,106,13
E0752,Finance,46,62,12.65494235,1,9,3,20,5,0.878802685,1.464671142,108,12
E0753,Marketing,68,68,1.523924767,-3,8,5,21,12,5.150708203,8.320374789,136,13
E0754,Sales,38,73,8.414862669,-1,9,4,16,4,1.380795499,1.699440615,111,13
E0755,Marketing,57,61,10.45993585,0,12,3,21,9,1.30890785,1.83247099,118,15
E0756,HR,53,82,8.96745866,0,5,5,23,2,1.003264758,2.307508943,135,10
E0757,Marketing,52,68,7.986776274,-1,8,6,16,5,1.557844501,1.780393715,120,14
E0758,Marketing,49,64,9.599573592,0,11,3,21,10,1.320807849,1.981211774,113,14
E0759,Finance,63,62,13.11257147,1,4,3,23,7,0.49601166,1.629752597,125,7
E0760,Finance,49,75,14.10686472,1,9,7,16,10,1.059121154,1.059121154,124,16
E0761,Finance,62,64,12.11506349,1,8,4,17,10,0.914978414,1.29621942,126,12
E0762,Operations,46,64,14.66008378,2,9,6,25,4,0.957849281,1.596415469,110,15
E0763,HR,52,66,8.395658287,-1,11,1,25,7,1.277185657,2.660803452,118,12
E0764,Finance,46,60,11.79035397,1,13,5,25,11,1.407310544,1.954597977,106,18
E0765,Sales,47,81,6.943460378,-1,11,5,24,1,2.014235514,3.021353272,128,16
E0766,Operations,44,69,18.79337335,3,5,7,16,8,0.60626351,0.808351347,113,12
E0767,Engineering,53,66,10.30044119,0,9,1,13,10,0.884921202,1.150397563,119,10
E0768,Sales,61,90,12.41232079,1,14,6,18,4,1.491166242,1.342049618,151,20
E0769,Support,35,78,4.712605277,-2,13,3,24,3,2.800823657,4.201235485,113,16
E0770,Support,50,78,12.34400364,1,7,8,16,3,1.124100413,1.199040441,128,15
E0771,Sales,42,75,10.34109772,0,6,7,15,10,1.14627352,1.322623292,117,13
E0772,Finance,30,61,11.3923147,0,15,2,21,12,1.37181797,1.694598669,91,17
E0773,Engineering,48,73,10.04071655,0,8,6,18,8,1.268033641,1.630328967,121,14
E0774,Engineering,48,80,9.640608498,0,6,6,23,11,1.127755053,2.161530518,128,12
E0775,Operations,49,61,9.075554277,0,7,3,20,3,0.992501229,1.985002457,110,10
E0776,Engineering,51,72,9.731027266,0,5,4,26,2,0.83868951,2.422880807,123,9
E0777,Support,48,73,14.40482578,1,6,5,14,8,0.714061954,0.908806124,121,11
E0778,HR,60,61,8.897850132,0,12,3,18,7,1.515480615,1.818576737,121,15
E0779,Finance,54,69,16.77635126,2,8,7,13,12,0.843817709,0.731308681,123,15
E0780,Engineering,45,79,10.18413069,0,10,6,15,12,1.430598447,1.341186044,124,16
E0781,Operations,63,76,14.19990109,1,2,8,23,12,0.657899018,1.513167741,139,10
E0782,Support,55,73,13.43177832,1,8,3,19,4,0.76220683,1.31653907,128,11
E0783,HR,58,78,5.309689356,-2,5,6,27,6,1.743350485,4.279133009,136,11
E0784,Marketing,51,74,5.944396998,-1,15,6,19,10,3.024020661,2.736018693,125,21
E0785,Marketing,59,75,7.96530768,-1,11,5,19,8,1.784657099,2.119280306,134,16
E0786,HR,51,70,5.368948884,-2,7,9,26,8,2.512188477,4.082306276,121,16
E0787,Support,45,70,8.760813442,0,4,2,23,2,0.614702866,2.356360987,115,6
E0788,Operations,56,77,10.08435387,0,8,8,24,3,1.44347611,2.165214165,133,16
E0789,HR,59,79,11.9458284,1,6,10,25,8,1.235919364,1.931124006,138,16
E0790,Finance,44,56,10.54172924,0,7,2,24,11,0.779779166,2.079411108,100,9
E0791,Finance,46,70,10.01571935,0,9,8,23,9,1.543249193,2.087925378,116,17
E0792,Marketing,37,76,13.07122387,1,6,7,20,3,0.923871308,1.421340474,113,13
E0793,Engineering,54,74,12.66964953,1,3,4,14,2,0.512083356,1.024166711,128,7
E0794,Operations,40,59,15.72352374,2,4,5,11,5,0.538164094,0.657756115,99,9
E0795,Marketing,55,66,10.55987153,0,5,5,18,3,0.865061517,1.55711073,121,10
E0796,Engineering,53,60,2.767065404,-2,9,2,30,8,2.920044868,7.96375873,113,11
E0797,Engineering,49,81,11.28159585,0,8,5,19,6,1.058494365,1.547030225,130,13
E0798,Finance,54,65,16.80709364,2,9,7,13,10,0.898518328,0.730046141,119,16
E0799,Support,54,69,13.07795828,1,5,1,24,12,0.426198166,1.704792664,123,6
E0800,Sales,51,62,13.76590021,1,6,4,20,5,0.677236055,1.354472109,113,10
E0801,Support,57,76,10.28448962,0,8,6,16,4,1.240640957,1.41787538,133,14
E0802,Sales,51,72,12.73940995,1,6,2,19,1,0.582266635,1.382883259,123,8
E0803,HR,48,62,13.9237856,1,6,4,20,11,0.670071272,1.340142544,110,10
E0804,Finance,45,78,8.997249055,0,9,7,19,2,1.600440272,1.900522823,123,16
E0805,Engineering,59,66,8.497651151,-1,5,4,23,5,0.947602713,2.421651378,125,9
E0806,Operations,67,69,11.36410919,0,12,3,23,4,1.213188898,1.860222977,136,15
E0807,Sales,66,68,12.90778459,1,7,3,18,2,0.719021778,1.2942392,134,10
E0808,Support,51,80,1.733892906,-3,8,3,24,5,4.023566532,8.778690616,131,11
E0809,Engineering,48,63,9.415661899,0,5,4,24,4,0.864083347,2.30422226,111,9
E0810,Sales,44,84,4.139637251,-2,13,4,25,1,3.307626427,4.864156511,128,17
E0811,Sales,49,78,9.632268314,0,12,9,26,4,1.975119455,2.445385992,127,21
E0812,Sales,57,78,15.06884336,2,10,9,17,6,1.182412422,1.057947956,135,19
E0813,Operations,51,67,8.127944922,-1,6,8,27,1,1.533751586,2.957949487,118,14
E0814,Finance,47,83,9.141747172,0,9,6,16,12,1.479035096,1.577637435,130,15
E0815,Operations,54,69,11.9858073,1,6,5,31,4,0.847078641,2.387221624,123,11
E0816,Marketing,62,61,12.981356,1,14,6,14,11,1.430476414,1.00133349,123,20
E0817,Engineering,45,62,12.8684999,1,3,7,21,8,0.721058519,1.51422289,107,10
E0818,Finance,40,62,10.11195385,0,8,3,23,2,0.989924917,2.069843009,102,11
E0819,Finance,49,55,11.71140052,1,11,10,24,9,1.652060287,1.8880689,104,21
E0820,Finance,41,68,11.57974998,1,4,9,17,10,1.033406866,1.351378209,109,13
E0821,Support,50,78,7.888762893,-1,7,2,16,6,1.012514352,1.800025514,128,9
E0822,Finance,40,67,4.746863884,-2,1,3,19,8,0.696031798,3.306151039,107,4
E0823,Operations,50,70,7.308927184,-1,4,7,20,11,1.32387729,2.407049617,120,11
E0824,Finance,52,60,14.31619274,1,14,5,25,12,1.240517165,1.632259428,112,19
E0825,HR,56,69,16.63963956,2,5,6,27,9,0.623595509,1.530643521,125,11
E0826,Engineering,52,74,9.726944781,0,8,9,19,3,1.584794212,1.77124059,126,17
E0827,Finance,43,66,14.20054014,1,5,6,24,11,0.723658495,1.578891261,109,11
E0828,Engineering,58,65,9.107805476,0,13,5,17,9,1.780801979,1.681868536,123,18
E0829,HR,48,74,11.04709935,0,6,2,22,6,0.664060266,1.826165732,122,8
E0830,HR,40,67,8.157385085,-1,9,5,19,12,1.528820714,2.074828111,107,14
E0831,Engineering,57,75,13.04364561,1,4,3,23,8,0.498446073,1.637751381,132,7
E0832,Sales,43,59,8.08415234,-1,8,1,26,7,0.990736357,2.862127255,102,9
E0833,Marketing,54,68,7.322159503,-1,9,5,24,1,1.682255669,2.883866861,122,14
E0834,Support,40,67,10.14025296,0,9,6,18,6,1.346468527,1.615762232,107,15
E0835,Sales,50,75,12.45029926,1,8,4,20,3,0.892173458,1.486955763,125,12
E0836,Sales,50,67,10.49095934,0,8,6,25,5,1.218349103,2.175623398,117,14
E0837,Operations,49,72,8.592919795,0,12,6,22,2,1.876383873,2.293358067,121,18
E0838,Support,56,71,7.300965635,-1,8,5,22,3,1.56608286,2.65029407,127,13
E0839,Support,53,70,4.939324834,-2,13,4,16,8,2.862278201,2.693908895,123,17
E0840,Sales,51,55,8.631240738,0,4,3,23,6,0.726801478,2.388061998,106,7
E0841,Finance,58,57,9.541258493,0,4,3,22,12,0.664057333,2.087037332,115,7
E0842,Operations,62,64,11.66188168,1,12,4,23,11,1.263635249,1.81647567,126,16
E0843,Operations,51,55,6.498677868,-1,9,2,21,5,1.466925263,2.800493683,106,11
E0844,HR,63,70,12.0045628,1,9,4,18,12,0.999649139,1.384129577,133,13
E0845,Support,58,54,8.217524715,-1,11,4,19,3,1.627334937,2.06129092,112,15
E0846,Sales,51,70,8.458688215,-1,9,2,16,6,1.16295196,1.691566487,121,11
E0847,HR,48,79,13.7461593,1,15,4,24,9,1.288471094,1.627542434,127,19
E0848,Engineering,53,61,2.567954781,-2,7,8,13,2,4.204089155,3.643543934,114,15
E0849,Marketing,63,88,6.319513182,-1,5,4,22,5,1.229589971,3.005664373,151,9
E0850,Operations,50,79,10.13693668,0,8,5,19,11,1.167286874,1.706034662,129,13
E0851,Engineering,55,70,9.985087013,0,7,3,19,8,0.910325061,1.729617615,125,10
E0852,Engineering,49,68,4.894046468,-2,5,6,21,6,1.866290003,3.562917278,117,11
E0853,Finance,47,70,8.517378853,-1,10,4,18,5,1.470993245,1.891277029,117,14
E0854,Marketing,48,68,12.87404555,1,9,4,20,8,0.937001392,1.441540604,116,13
E0855,Engineering,48,78,6.511508699,-1,7,4,26,2,1.464419525,3.461355241,126,11
E0856,Engineering,52,89,13.24225683,1,11,7,21,5,1.263844643,1.474485417,141,18
E0857,Marketing,55,55,7.851519229,-1,9,6,19,1,1.694624348,2.146524174,110,15
E0858,Marketing,38,77,4.381227821,-2,11,6,21,10,3.159130326,3.902455109,115,17
E0859,Engineering,51,83,12.45725656,1,8,6,16,9,1.040330913,1.188949615,134,14
E0860,Marketing,51,83,10.75207533,0,13,3,23,8,1.361461661,1.957101138,134,16
E0861,Engineering,58,81,5.602190123,-1,9,6,18,4,2.271973348,2.726368018,139,15
E0862,Engineering,44,72,8.371663062,-1,13,4,17,1,1.813979001,1.813979001,116,17
E0863,Finance,47,62,15.17488925,2,5,0,19,2,0.309121127,1.174660284,109,5
E0864,Sales,51,76,11.97505703,1,3,9,16,4,0.924851426,1.233135235,127,12
E0865,Engineering,55,83,13.34615818,1,5,2,27,7,0.48793551,1.882036965,138,7
E0866,HR,49,67,6.585046995,-1,6,4,21,7,1.318383394,2.768605127,116,10
E0867,Operations,38,77,13.67583536,1,6,7,21,9,0.885809883,1.430923657,115,13
E0868,Support,55,82,5.728140971,-1,4,8,25,5,1.783553593,3.715736651,137,12
E0869,Sales,52,88,5.823042396,-1,4,6,19,11,1.465621847,2.78468151,140,10
E0870,Sales,60,69,12.50535794,1,3,7,15,3,0.740446869,1.110670303,129,10
E0871,Sales,52,79,6.006758713,-1,9,6,25,10,2.140790145,3.567983575,131,15
E0872,Finance,35,82,14.55268286,2,11,5,21,10,1.028761413,1.350249355,117,16
E0873,Engineering,50,75,6.242770366,-1,4,3,14,3,0.966481007,1.932962015,125,7
E0874,Finance,59,57,7.083813015,-1,9,5,23,4,1.731855991,2.845191985,116,14
E0875,Engineering,50,67,13.45951469,1,7,5,22,12,0.829903372,1.521489515,117,12
E0876,Finance,45,70,8.137743671,-1,8,3,24,2,1.203798268,2.626468947,115,11
E0877,Finance,58,54,12.38546447,1,12,6,20,2,1.344742279,1.494158088,112,18
E0878,Operations,62,72,6.659840908,-1,13,6,15,3,2.480469272,1.958265215,134,19
E0879,HR,46,71,9.170197781,0,8,6,27,3,1.376571066,2.654815627,117,14
E0880,Finance,46,78,12.22259475,1,5,6,16,4,0.831909335,1.210049941,124,11
E0881,Operations,52,67,7.462827646,-1,3,6,15,1,1.063474335,1.772457224,119,9
E0882,Marketing,51,77,13.06818054,1,6,9,14,7,1.066235961,0.995153564,128,15
E0883,HR,55,77,8.919143477,0,7,3,19,5,1.008151563,1.91548797,132,10
E0884,Finance,48,64,10.3602735,0,9,4,8,1,1.144338646,0.704208398,112,13
E0885,Support,49,66,6.992012435,-1,6,2,22,5,1.000999443,2.75274847,115,8
E0886,Sales,50,80,7.688914773,-1,6,5,24,4,1.265980883,2.762140109,130,11
E0887,Marketing,44,66,7.467572934,-1,9,2,16,8,1.299073546,1.889561522,110,11
E0888,Marketing,52,72,8.17308019,-1,9,5,21,7,1.526204907,2.289307361,124,14
E0889,Operations,39,73,14.63860916,2,14,2,20,9,1.023108887,1.278886108,112,16
E0890,Marketing,48,61,13.36236974,1,7,4,18,2,0.765890323,1.253275074,109,11
E0891,HR,57,72,11.35539873,0,11,3,19,10,1.133107907,1.537789303,129,14
E0892,Finance,52,69,8.024145293,-1,8,1,18,12,0.997324368,1.994648736,121,9
E0893,Finance,53,56,7.473763136,-1,7,7,16,8,1.652158524,1.888181171,109,14
E0894,Support,48,72,7.091157124,-1,8,5,16,8,1.606692319,1.977467469,120,13
E0895,Sales,46,83,9.088498788,0,7,2,9,12,0.892104979,0.892104979,129,9
E0896,Operations,41,70,10.84038764,0,7,2,22,1,0.760110249,1.858047275,111,9
E0897,Sales,50,55,11.84281467,1,7,9,24,10,1.245832818,1.868749228,105,16
E0898,Marketing,59,77,10.0432245,0,7,4,28,10,0.996085881,2.535491332,136,11
E0899,Support,46,73,11.69634436,1,12,7,18,6,1.496493751,1.417730922,119,19
E0900,Sales,50,82,12.80785391,1,7,3,18,9,0.724225507,1.303605912,132,10
E0901,HR,42,83,8.884731797,0,10,5,17,10,1.517491856,1.719824103,125,15
E0902,Finance,58,63,13.29514042,1,6,3,24,9,0.629584582,1.678892217,121,9
E0903,Marketing,46,66,7.04879943,-1,9,7,18,1,1.98787411,2.236358373,112,16
E0904,Support,51,64,11.75914575,1,11,1,27,4,0.940501836,2.11612913,115,12
E0905,Sales,43,69,10.09589227,0,8,8,20,7,1.441975067,1.802468833,112,16
E0906,Operations,38,67,10.52590016,0,7,8,23,11,1.301416791,1.995505746,105,15
E0907,HR,54,69,8.896595594,0,9,3,23,4,1.212538179,2.32403151,123,12
E0908,HR,58,69,13.74196327,1,7,3,14,8,0.678335702,0.949669983,127,10
E0909,Sales,56,59,8.187291143,-1,9,8,13,9,1.8503822,1.414998153,115,17
E0910,Finance,41,73,14.16237468,1,5,6,19,9,0.725480027,1.253101866,114,11
E0911,Sales,50,72,14.1820962,1,12,4,24,2,1.053872917,1.580809375,122,16
E0912,Marketing,58,73,11.35333626,0,7,6,16,2,1.052347295,1.295196671,131,13
E0913,Sales,63,81,9.061490148,0,7,2,21,7,0.894499708,2.087165985,144,9
E0914,HR,46,71,7.486679813,-1,7,1,18,4,0.942653685,2.120970792,117,8
E0915,Support,54,80,4.01688311,-2,4,7,10,8,2.192596431,1.993269482,134,11
E0916,Sales,39,73,11.61963436,1,7,5,24,12,0.950899183,1.901798366,112,12
E0917,Finance,57,70,6.665514851,-1,8,2,19,8,1.304543817,2.478633252,127,10
E0918,Support,50,72,7.085550332,-1,5,4,23,11,1.113096775,2.844580648,122,9
E0919,Operations,42,63,11.6530235,1,7,5,15,11,0.948389925,1.185487406,105,12
E0920,Engineering,52,75,8.710344998,0,6,10,20,9,1.647727244,2.059659055,127,16
E0921,Sales,40,73,10.65279874,0,7,4,12,12,0.943979231,1.029795525,113,11
E0922,Finance,43,96,11.38174798,0,5,3,27,12,0.646112327,2.180629103,139,8
E0923,Support,50,58,14.81410045,2,8,5,25,11,0.822051184,1.580867661,108,13
E0924,Finance,44,71,10.59572102,0,10,4,26,3,1.207341914,2.242206411,115,14
E0925,Operations,45,79,8.351156039,-1,5,8,23,2,1.390202446,2.459588943,124,13
E0926,HR,55,66,9.77476527,0,5,9,22,7,1.29933225,2.041807821,121,14
E0927,Finance,45,80,8.266394171,-1,9,4,20,3,1.402918952,2.158336849,125,13
E0928,Support,48,60,15.63926375,2,7,5,18,1,0.721185756,1.081778633,108,12
E0929,Finance,59,73,11.11670078,0,9,4,24,10,1.072899317,1.980737201,132,13
E0930,Finance,57,66,11.75400304,1,10,5,15,7,1.176101335,1.176101335,123,15
E0931,Finance,48,62,14.05750573,1,8,4,30,10,0.796944741,1.992361852,110,12
E0932,Marketing,55,63,7.457050923,-1,16,9,23,10,2.956113216,2.719624158,118,25
E0933,Marketing,59,57,5.720533882,-1,13,6,18,11,2.827156344,2.678358642,116,19
E0934,HR,59,56,9.931777662,0,5,5,17,5,0.914764305,1.555099319,115,10
E0935,Sales,36,66,5.728963533,-1,14,6,24,5,2.972225945,3.566671135,102,20
E0936,Finance,54,71,8.766683231,0,13,5,19,12,1.843000287,1.945389192,125,18
E0937,Operations,42,72,3.463261577,-2,6,3,21,6,2.01646259,4.705079377,114,9
E0938,Sales,49,74,5.944953893,-1,9,8,20,4,2.447820426,2.879788737,123,17
E0939,Operations,56,79,13.66879007,1,7,5,15,8,0.818063381,1.022579226,135,12
E0940,Sales,49,79,11.21391063,0,6,4,13,8,0.818738592,1.06436017,128,10
E0941,HR,40,70,15.39295445,2,8,8,18,4,0.976029065,1.098032698,110,16
E0942,Finance,58,74,9.906585791,0,7,4,17,1,1.008564936,1.558691265,132,11
E0943,Finance,57,76,9.791403379,0,10,4,19,8,1.297328949,1.760660716,133,14
E0944,Engineering,48,67,10.64642385,0,7,5,17,6,1.030359204,1.459675539,115,12
E0945,Operations,55,77,20.76604385,4,5,3,23,4,0.367544973,1.056691797,132,8
E0946,Sales,65,66,13.15781421,1,8,3,20,11,0.776956092,1.41264744,131,11
E0947,Sales,39,72,7.478186158,-1,6,6,17,3,1.415397088,2.005145875,111,12
E0948,Marketing,52,73,11.22202645,0,8,4,21,1,0.981833909,1.71820934,125,12
E0949,Engineering,47,71,10.45769715,0,6,3,16,5,0.785498157,1.396441169,118,9
E0950,Support,47,65,12.16271507,1,15,4,15,2,1.443471191,1.139582519,112,19
E0951,Support,60,78,15.61966004,2,12,4,16,10,0.96271524,0.96271524,138,16
E0952,Marketing,59,63,11.76332675,1,12,8,17,5,1.566989578,1.331941141,122,20
E0953,Marketing,50,75,8.887721971,0,6,3,20,2,0.910219768,2.022710596,125,9
E0954,Marketing,50,73,15.59304676,2,7,2,22,11,0.542395868,1.325856566,123,9
E0955,Operations,54,61,6.082380101,-1,8,4,16,8,1.694345662,2.259127549,115,12
E0956,Operations,43,62,9.186522003,0,6,3,24,9,0.883520401,2.356054401,105,9
E0957,HR,42,61,12.70437568,1,9,5,21,3,1.021571528,1.532357292,103,14
E0958,HR,48,63,7.628491852,-1,14,7,19,4,2.43379728,2.202007063,111,21
E0959,Marketing,42,74,9.844674272,0,13,4,21,12,1.567589729,1.936434371,116,17
E0960,Engineering,42,85,7.896029975,-1,7,6,22,1,1.461326011,2.47301325,127,13
E0961,Sales,46,70,9.884981454,0,7,5,19,1,1.102436421,1.745524334,116,12
E0962,Operations,50,72,7.901203076,-1,5,2,19,1,0.786410549,2.134542919,122,7
E0963,Engineering,55,68,10.23713432,0,10,7,18,8,1.512841221,1.601831881,123,17
E0964,Finance,59,85,9.01113243,0,11,8,13,11,1.89788719,1.298554393,144,19
E0965,Operations,58,63,13.98172382,1,7,3,23,1,0.667479932,1.535203845,121,10
E0966,Operations,57,79,11.15649885,0,8,4,21,3,0.987126322,1.727471064,136,12
E0967,HR,51,66,12.21438937,1,10,3,16,6,0.983776067,1.210801313,117,13
E0968,Sales,55,71,10.43293062,0,14,4,18,12,1.574399478,1.574399478,126,18
E0969,Sales,46,68,8.696734432,0,11,12,19,2,2.371932547,1.959422539,114,23
E0970,Support,49,88,11.00440192,0,5,3,12,10,0.666422205,0.999633308,137,8
E0971,Support,48,76,10.60837842,0,11,7,20,11,1.550604171,1.722893524,124,18
E0972,Support,53,74,2.735762085,-2,12,4,22,4,4.282927991,5.889025987,127,16
E0973,Support,47,71,10.10065918,0,7,2,19,6,0.810762663,1.711610067,118,9
E0974,Finance,44,68,12.01588499,1,7,2,22,8,0.691462778,1.690242347,112,9
E0975,Finance,58,71,7.851702748,-1,8,5,21,4,1.468643985,2.372424899,129,13
E0976,Operations,66,69,12.60256148,1,6,6,16,4,0.882186786,1.176249048,135,12
E0977,Marketing,57,70,11.06677507,0,2,4,15,1,0.497233102,1.243082755,127,6
E0978,HR,46,59,8.80965644,0,5,8,16,10,1.325224801,1.631045909,105,13
E0979,HR,50,59,11.62571006,1,4,5,23,10,0.712831196,1.821679723,109,9
E0980,Support,53,64,8.894223943,0,7,3,20,6,1.010690688,2.021381375,117,10
E0981,Operations,43,69,10.83039442,0,5,3,19,11,0.676224284,1.606032676,112,8
E0982,Engineering,50,47,9.220235167,0,6,6,24,2,1.17414128,2.34828256,97,12
E0983,Marketing,39,66,11.64701575,1,5,2,18,4,0.553490257,1.423260661,105,7
E0984,Operations,53,70,14.04047422,1,5,6,29,5,0.731359918,1.928130694,123,11
E0985,Marketing,44,71,8.691643152,0,8,7,20,2,1.547725165,2.063633554,115,15
E0986,Marketing,48,63,12.7066805,1,6,7,21,7,0.948442623,1.532099622,111,13
E0987,Marketing,62,64,9.103113201,0,10,3,21,9,1.286732093,2.078567228,126,13
E0988,Operations,47,58,9.12663239,0,5,6,21,9,1.086244625,2.073739738,105,11
E0989,Support,44,61,8.814206601,0,9,1,17,7,1.018931067,1.732182813,105,10
E0990,HR,53,75,4.935979886,-2,9,7,23,6,2.695426923,3.874676202,128,16
E0991,HR,55,66,11.50106896,0,13,4,16,12,1.359883707,1.279890548,121,17
E0992,Support,53,80,10.85213953,0,9,6,11,3,1.26559428,0.928102472,133,15
E0993,Marketing,52,53,10.48885118,0,8,7,24,9,1.305613569,2.088981711,105,15
E0994,Engineering,41,75,14.66356122,2,6,6,16,8,0.766109305,1.021479073,116,12
E0995,Sales,44,65,14.99386339,2,9,7,20,6,1.000383685,1.250479607,109,16
E0996,Operations,47,58,13.92384418,1,9,4,20,11,0.871089234,1.340137283,105,13
E0997,Sales,59,86,9.294014806,0,6,2,16,3,0.777150621,1.554301242,145,8
E0998,Support,54,65,9.141842743,0,8,6,21,1,1.380419748,2.070629622,119,14
E0999,Engineering,47,44,6.945527949,-1,6,7,14,10,1.636140491,1.761997452,91,13
E1000,Operations,38,89,10.18551031,0,9,4,25,6,1.162217873,2.235034372,127,13
E1001,Support,52,65,10.02476011,0,8,7,21,3,1.360573822,1.90480335,117,15
E1002,Marketing,63,75,11.61533469,1,13,3,20,2,1.268297703,1.585372128,138,16
E1003,HR,57,63,6.793460778,-1,12,4,20,5,2.053003211,2.566254013,120,16
E1004,Sales,55,76,8.877216253,0,4,6,18,5,1.012431007,1.822375813,131,10
E1005,Finance,50,54,4.915163238,-2,6,6,21,3,2.028684504,3.550197882,104,12
E1006,Finance,49,73,7.85188381,-1,14,4,11,8,2.033465462,1.242673338,122,18
E1007,Engineering,51,61,12.67790368,1,10,5,21,9,1.09665928,1.535322991,112,15
E1008,Marketing,49,66,6.695725195,-1,4,7,18,4,1.429364968,2.338960857,115,11
E1009,Sales,46,71,15.23193451,2,9,6,14,9,0.924104271,0.862497319,117,15
E1010,Marketing,56,92,13.02670744,1,9,4,17,2,0.92680339,1.211973663,148,13
E1011,Sales,48,67,11.50372346,0,7,2,23,10,0.719785593,1.839452071,115,9
E1012,Engineering,59,78,14.00060839,1,8,6,20,4,0.933295479,1.333279256,137,14
E1013,Engineering,42,75,9.636898701,0,3,3,19,3,0.564074188,1.786234929,117,6
E1014,Finance,57,69,7.787426557,-1,6,5,23,7,1.251788556,2.617376072,126,11
E1015,Marketing,48,74,9.712173028,0,7,5,25,5,1.12022089,2.33379352,122,12
E1016,Operations,58,65,4.843464258,-2,10,6,28,3,2.738101799,4.791678149,123,16
E1017,Finance,52,64,13.57221429,1,7,3,31,8,0.686237506,2.12733627,116,10
E1018,Marketing,50,69,8.953334266,0,8,13,20,4,2.10984575,2.009376905,119,21
E1019,Finance,73,52,7.734379687,-1,8,6,22,3,1.602861394,2.51878219,125,14
E1020,Operations,47,65,8.081365128,-1,7,4,27,7,1.211271636,2.97312129,112,11
E1021,HR,46,68,10.04972931,0,4,4,31,9,0.723999636,2.805498589,114,8
E1022,HR,49,82,10.35886906,0,6,4,23,9,0.880369335,2.02484947,131,10
E1023,HR,47,60,9.56168783,0,10,6,21,4,1.514909384,1.988318566,107,16
E1024,HR,50,67,9.548351166,0,7,3,19,9,0.948015462,1.801229377,117,10
E1025,Support,68,81,11.64927806,1,6,5,18,9,0.869614847,1.423006113,149,11
E1026,Sales,56,59,6.703972741,-1,2,8,23,5,1.298031592,2.985472661,115,10
E1027,Support,34,59,10.67557426,0,12,4,23,4,1.370382273,1.969924518,93,16
E1028,Support,43,76,9.046411323,0,10,7,25,7,1.692146524,2.488450771,119,17
E1029,Support,64,69,4.006036082,-2,8,10,17,2,3.595659261,3.395900413,133,18
E1030,HR,45,64,6.75009029,-1,7,4,27,3,1.419338303,3.48383038,109,11
E1031,Operations,40,62,7.624057425,-1,7,4,18,2,1.275501711,2.087184618,102,11
E1032,Engineering,51,61,15.01117932,2,11,4,24,10,0.936845419,1.498952671,112,15
E1033,Engineering,50,72,11.35751217,0,7,2,19,5,0.728301933,1.537526303,122,9
E1034,Sales,56,67,10.81296826,0,6,10,16,9,1.354443663,1.354443663,123,16
E1035,HR,65,80,8.539084705,0,7,5,26,10,1.25798233,2.725628381,145,12
E1036,HR,63,57,8.462954259,-1,7,6,15,4,1.373778172,1.58512866,120,13
E1037,HR,51,61,6.451360648,-1,13,7,15,11,2.684073547,2.01305516,112,20
E1038,Finance,45,76,9.020772001,0,12,3,16,1,1.496890659,1.596683369,121,15
E1039,Marketing,58,71,14.12682811,1,9,4,22,12,0.859400259,1.45436967,129,13
E1040,Finance,52,60,6.045648011,-1,13,7,18,1,2.83863173,2.554768557,112,20
E1041,Marketing,48,67,8.240716085,-1,8,8,17,7,1.731467546,1.839684267,115,16
E1042,HR,55,64,12.77856119,1,10,2,23,4,0.870918221,1.669259923,119,12
E1043,HR,36,70,12.77042343,1,6,4,20,1,0.726194082,1.452388164,106,10
E1044,Finance,40,63,7.838378427,-1,6,4,19,3,1.131429264,2.149715602,103,10
E1045,Finance,49,57,13.49086026,1,15,2,16,4,1.173153263,1.104144247,106,17
E1046,Marketing,48,70,8.695909129,0,8,4,12,1,1.237635362,1.237635362,118,12
E1047,Engineering,47,62,6.552221254,-1,10,8,18,11,2.383404749,2.383404749,109,18
E1048,Marketing,54,73,14.49493597,1,12,5,15,7,1.097132639,0.968058211,127,17
E1049,Finance,52,69,10.27588204,0,10,7,22,11,1.507642589,1.95106688,121,17
E1050,Operations,56,70,9.496415615,0,7,6,14,11,1.238518031,1.333788649,126,13
E1051,Finance,51,74,10.5244892,0,10,9,17,9,1.648663092,1.475119608,125,19
E1052,Operations,55,73,7.090227412,-1,8,6,17,4,1.730482876,2.101300635,128,14
E1053,Sales,44,62,8.314289237,-1,3,8,19,5,1.180981148,2.039876529,106,11
E1054,Finance,39,80,14.31070549,1,11,3,18,8,0.914392874,1.175647981,119,14
E1055,Sales,41,67,15.57739798,2,12,4,19,12,0.965169565,1.146138858,108,16
E1056,Engineering,58,66,6.660489664,-1,7,6,27,3,1.697019456,3.52457887,124,13
E1057,Marketing,45,76,8.831924282,0,11,9,22,1,2.034189791,2.23760877,121,20
E1058,Operations,46,58,10.01316479,0,6,3,18,2,0.81720379,1.63440758,104,9
E1059,Marketing,54,64,10.6020816,0,6,3,21,8,0.775722867,1.810020023,118,9
E1060,Sales,58,69,7.148843044,-1,5,6,23,2,1.349884878,2.822486563,127,11
E1061,Operations,50,65,11.95132151,1,9,4,27,11,1.003758573,2.084729344,115,13
E1062,Marketing,46,63,12.17796701,1,8,8,13,12,1.214147826,0.986495109,109,16
E1063,Finance,43,62,12.55093535,1,5,3,21,8,0.590365151,1.549708523,105,8
E1064,HR,44,64,12.25739248,1,4,3,21,9,0.528007299,1.584021898,108,7
E1065,Sales,43,79,10.24369792,0,6,4,17,12,0.88938711,1.511958087,122,10
E1066,Marketing,50,67,12.97166759,1,11,6,17,11,1.216748101,1.216748101,117,17
E1067,Sales,38,68,11.63219879,1,12,5,25,1,1.345767296,1.979069552,106,17
E1068,Support,53,72,5.548374648,-1,9,5,20,6,2.137935099,3.054192998,125,14
E1069,Sales,44,66,5.569471631,-1,10,4,13,5,2.131069405,1.978850162,110,14
E1070,Operations,63,67,10.92572428,0,9,13,18,4,1.844751689,1.509342291,130,22
E1071,Support,48,87,13.85745543,1,4,4,20,12,0.53845021,1.346125526,135,8
E1072,Operations,45,68,11.33813637,0,4,2,20,3,0.486297105,1.620990351,113,6
E1073,HR,55,71,11.76494709,1,13,7,24,12,1.566790669,1.880148803,126,20
E1074,Support,52,60,6.82273181,-1,10,7,13,8,2.173153882,1.661823557,112,17
E1075,Finance,50,60,10.20202906,0,8,2,17,3,0.892695417,1.517582209,110,10
E1076,Sales,58,73,13.42631979,1,11,5,19,6,1.109083968,1.317037212,131,16
E1077,Marketing,60,88,11.33743452,0,8,9,37,7,1.377920181,2.999002747,148,17
E1078,Engineering,42,69,10.31392697,0,10,2,28,8,1.060639691,2.474825946,111,12
E1079,Sales,40,70,11.78237627,1,9,6,21,11,1.173490725,1.642887015,110,15
E1080,Sales,40,66,10.67962377,0,8,1,21,11,0.770572766,1.798003122,106,9
E1081,HR,41,62,13.52361519,1,6,2,21,1,0.550827042,1.445920986,103,8
E1082,Finance,55,76,10.67736264,0,4,6,22,7,0.85635775,1.88398705,131,10
E1083,Engineering,56,63,9.907757347,0,10,2,21,8,1.100134484,1.925235347,119,12
E1084,Support,56,76,6.857914011,-1,6,10,15,6,2.036163793,1.908903556,132,16
E1085,Support,53,75,13.64317553,1,10,3,20,12,0.887785574,1.365823961,128,13
E1086,Support,48,75,7.178742919,-1,9,3,26,8,1.467218143,3.178972644,123,12
E1087,Operations,58,67,10.71243509,0,10,3,21,3,1.109931445,1.79296618,125,13
E1088,Operations,50,72,12.40286819,1,8,1,20,3,0.671498061,1.492217913,122,9
E1089,Marketing,45,73,15.36800749,2,7,4,22,9,0.672042703,1.344085407,118,11
E1090,Engineering,54,71,10.67988826,0,10,6,28,9,1.369876119,2.397283208,125,16
E1091,Support,48,69,14.17387664,1,5,4,24,12,0.593124632,1.581665686,117,9
E1092,Operations,64,73,10.08215916,0,10,7,20,1,1.533997098,1.804702469,137,17
E1093,Marketing,40,70,8.318719533,-1,1,7,18,12,0.858487045,1.931595852,110,8
E1094,Finance,50,59,18.29926492,3,6,4,19,6,0.51815445,0.984493455,109,10
E1095,Marketing,45,50,6.345740272,-1,14,3,19,12,2.314266414,2.586533051,95,17
E1096,Operations,38,63,18.76397312,3,3,6,26,2,0.455374026,1.315524963,101,9
E1097,HR,45,79,14.88510076,2,4,3,20,10,0.440664501,1.259041431,124,7
E1098,HR,55,79,8.275592677,-1,11,6,19,3,1.832766982,2.048386627,134,17
E1099,Support,50,66,11.94954416,1,7,5,22,12,0.926673546,1.6989015,116,12
E1100,HR,48,57,5.806737374,-1,8,3,17,12,1.616045896,2.497525476,105,11
E1101,Support,46,59,11.77909691,1,4,5,23,2,0.704275119,1.799814194,105,9
E1102,Support,47,52,10.96629852,0,8,3,18,9,0.919248336,1.504224549,99,11
E1103,Operations,49,60,12.59942252,1,6,5,20,1,0.808857875,1.470650682,109,11
E1104,HR,55,62,8.788065971,0,14,2,17,9,1.634643662,1.736808891,117,16
E1105,Support,53,61,10.47707362,0,8,4,15,12,1.045562692,1.306953366,114,12
E1106,Engineering,44,66,11.42882402,0,6,9,20,10,1.206872024,1.609162699,110,15
E1107,Finance,44,60,8.534610733,0,4,4,14,7,0.839048413,1.468334722,104,8
E1108,Marketing,59,60,14.21828606,1,4,5,27,7,0.591393799,1.774181396,119,9
E1109,Marketing,41,58,10.39041558,0,10,5,15,7,1.316896639,1.316896639,99,15
E1110,Operations,61,69,11.03312192,0,8,2,31,10,0.831039532,2.576222548,130,10
E1111,HR,35,71,7.501666367,-1,6,7,23,3,1.529111993,2.705351987,106,13
E1112,HR,51,54,5.045975514,-2,8,2,20,1,1.653992805,3.30798561,105,10
E1113,Support,49,82,5.960977595,-1,5,7,14,9,1.723895794,2.01121176,131,12
E1114,Sales,49,73,11.78894346,1,4,4,25,12,0.625540337,1.954813552,122,8
E1115,Support,50,67,7.629127608,-1,20,6,22,3,3.013050818,2.549504539,117,26
E1116,Finance,42,71,12.18663313,1,9,4,19,2,0.985846794,1.440853007,113,13
E1117,Engineering,55,67,14.96422464,2,12,4,24,12,1.002240971,1.503361456,122,16
E1118,Marketing,46,74,12.31292956,1,10,4,23,9,1.05160926,1.727643784,120,14
E1119,Support,40,76,11.27893193,0,8,2,21,5,0.814403081,1.710246471,116,10
E1120,Sales,35,70,11.96704683,1,11,5,14,6,1.233896986,1.079659863,105,16
E1121,Sales,51,75,13.31207085,1,8,4,32,9,0.838453088,2.235874901,126,12
E1122,Support,49,77,10.93515747,0,11,6,19,1,1.424363277,1.591935427,126,17
E1123,Operations,46,64,11.99108488,1,7,7,16,8,1.077662115,1.231613845,110,14
E1124,Marketing,46,78,8.303753163,-1,8,2,20,3,1.07483505,2.149670101,124,10
E1125,Operations,53,70,7.071363118,-1,7,5,18,3,1.48673772,2.23010658,123,12
E1126,Engineering,56,79,8.482620315,-1,11,3,15,4,1.476385169,1.581841253,135,14
E1127,Sales,57,69,9.020927832,0,12,0,18,3,1.197493905,1.796240857,126,12
E1128,Sales,58,77,8.898504727,0,6,6,21,1,1.212304316,2.121532553,135,12
E1129,Finance,59,69,13.43992758,1,9,4,18,7,0.900281523,1.246543648,128,13
E1130,Engineering,46,55,1.852708777,-3,8,2,25,2,3.505440191,8.763600478,101,10
E1131,Sales,44,71,9.358803254,0,8,5,16,1,1.254971224,1.544579968,115,13
E1132,Engineering,52,78,12.22984149,1,11,6,21,10,1.284973823,1.587320605,130,17
E1133,Marketing,50,86,12.12028939,1,11,4,15,6,1.143267466,1.143267466,136,15
E1134,HR,45,73,7.543201823,-1,9,5,10,6,1.638729869,1.170521335,118,14
E1135,Sales,49,66,15.21615345,2,9,5,19,6,0.863336675,1.171671202,115,14
E1136,Finance,55,59,5.848741686,-1,11,5,25,11,2.336195572,3.650305581,114,16
E1137,Marketing,46,67,8.950098598,0,7,2,20,11,0.90451365,2.010030333,113,9
E1138,Support,44,66,9.070514549,0,5,9,21,2,1.390197088,2.085295632,110,14
E1139,Engineering,61,62,9.040449504,0,9,5,17,5,1.394359883,1.693151287,123,14
E1140,Support,48,65,14.07910127,1,9,5,13,10,0.928437295,0.862120346,113,14
E1141,Operations,50,70,10.04788907,0,8,3,21,3,0.99566532,1.90081561,120,11
E1142,Marketing,63,62,10.95932643,0,8,5,23,11,1.087017741,1.923185235,125,13
E1143,Support,42,72,12.63795187,1,7,6,16,7,0.953222311,1.17319669,114,13
E1144,Sales,49,76,8.081254798,-1,14,8,14,7,2.422572705,1.541637176,125,22
E1145,Engineering,52,81,9.535810113,0,11,4,23,9,1.423715864,2.183030992,133,15
E1146,HR,44,66,15.02820378,2,8,4,18,4,0.748680274,1.123020411,110,12
E1147,Marketing,47,78,11.13472879,0,6,3,19,5,0.741672942,1.565753988,125,9
E1148,Sales,39,67,6.715068999,-1,13,9,13,11,2.851562313,1.685014094,106,22
E1149,Finance,60,59,7.430924047,-1,7,6,13,11,1.541942488,1.541942488,119,13
E1150,Operations,51,78,12.6757986,1,10,7,12,11,1.24307183,0.877462468,129,17
E1151,Engineering,56,73,6.611577543,-1,7,1,21,12,1.05103048,2.75895501,129,8
E1152,Marketing,52,80,8.581029728,0,5,4,22,4,0.939356234,2.296204127,132,9
E1153,Marketing,39,61,10.60990659,0,6,12,28,1,1.550400071,2.411733444,100,18
E1154,HR,52,72,10.04086452,0,7,4,19,4,0.996298793,1.720879734,124,11
E1155,HR,59,69,14.44965278,1,12,2,22,3,0.906169232,1.423980222,128,14
E1156,Finance,45,73,2.648147783,-2,9,6,18,4,4.111675539,4.934010646,118,15
E1157,Operations,63,64,11.44584152,0,9,6,20,3,1.205221839,1.606962452,127,15
E1158,Finance,53,68,9.152251363,0,9,2,23,5,1.083503511,2.265507342,121,11
E1159,Sales,55,53,13.95102463,1,8,8,23,12,1.070160768,1.538356104,108,16
E1160,Sales,46,67,9.293118635,0,8,5,21,4,1.262979711,2.040197995,113,13
E1161,Finance,47,51,9.380052214,0,7,6,31,10,1.252402178,2.986497501,98,13
E1162,Operations,39,75,9.987770241,0,8,5,17,12,1.183133585,1.547174688,114,13
E1163,Finance,41,61,8.016578043,-1,8,5,20,12,1.441788663,2.218136404,102,13
E1164,Operations,50,78,8.227261984,-1,8,8,16,9,1.733992167,1.733992167,128,16
E1165,Operations,55,63,9.553132902,0,7,3,15,11,0.947585906,1.421378859,118,10
E1166,Support,51,73,14.93491729,2,6,5,26,10,0.690307944,1.631636959,124,11
E1167,Engineering,64,70,8.525950448,-1,3,4,17,4,0.734834811,1.784598827,134,7
E1168,Operations,49,89,7.937507874,-1,7,8,28,3,1.6783202,3.132864373,138,15
E1169,HR,46,63,8.799555681,0,6,4,20,12,1.020454429,2.040908859,109,10
E1170,Operations,53,59,10.01018811,0,9,6,15,9,1.362374544,1.362374544,112,15
E1171,Operations,55,56,15.37733372,2,7,7,24,9,0.854840002,1.465440004,111,14
E1172,Operations,52,73,7.708644179,-1,12,4,17,11,1.837254993,1.95208343,125,16
E1173,Support,50,62,17.49727885,2,5,6,22,7,0.594682066,1.189364132,112,11
E1174,Support,54,67,11.35689806,0,7,4,13,5,0.890191045,1.052043963,121,11
E1175,Sales,43,71,6.999021593,-1,5,5,18,8,1.250152895,2.250275211,114,10
E1176,Support,65,69,8.358234675,-1,11,5,14,7,1.709724169,1.496008648,134,16
E1177,HR,40,77,4.190650734,-2,10,5,18,7,2.889811079,3.467773295,117,15
E1178,HR,40,79,10.32004572,0,7,11,13,12,1.590099585,1.148405256,119,18
E1179,Support,45,71,13.1546058,1,8,3,23,7,0.777132204,1.62491279,116,11
E1180,Finance,55,71,10.09326694,0,9,6,20,3,1.352171554,1.802895406,126,15
E1181,Engineering,60,81,12.4084222,1,6,8,16,2,1.044119867,1.193279848,141,14
E1182,Support,45,78,11.28546184,0,9,6,27,10,1.22095532,2.197719577,123,15
E1183,Operations,46,83,13.63040347,1,4,9,17,12,0.888560594,1.161963854,129,13
E1184,Marketing,52,52,7.060786399,-1,13,6,18,12,2.357090123,2.233032748,104,19
E1185,Engineering,50,59,12.64864665,1,7,7,16,2,1.025742725,1.1722774,109,14
E1186,Engineering,46,69,15.66032783,2,5,4,22,1,0.540205457,1.320502227,115,9
E1187,HR,46,72,17.69589735,3,4,3,16,12,0.374413695,0.855802731,118,7
E1188,Engineering,37,76,14.26097853,1,8,8,26,3,1.048425563,1.703691539,113,16
E1189,Support,57,81,10.51441423,0,9,5,19,4,1.215867322,1.650105652,138,14
E1190,Operations,50,81,7.104180344,-1,9,5,16,11,1.727503511,1.974289727,131,14
E1191,Operations,46,80,7.550131063,-1,6,2,22,10,0.935658172,2.573059973,126,8
E1192,Sales,49,72,9.480475023,0,9,8,13,4,1.622063882,1.240401792,121,17
E1193,Operations,67,80,15.57976716,2,8,1,20,9,0.542830301,1.206289558,147,9
E1194,Operations,56,75,8.408890878,-1,12,6,14,11,1.913084149,1.487954338,131,18
E1195,HR,44,78,10.53879169,0,6,2,21,7,0.693313495,1.819947925,122,8
E1196,Operations,34,76,12.82229133,1,10,5,26,9,1.085203577,1.881019534,110,15
E1197,Sales,43,73,0.143001388,-3,3,2,24,7,4.374447882,20.99734983,116,5
E1198,Marketing,51,76,6.809762437,-1,9,8,24,11,2.176762755,3.073076831,127,17
E1199,Support,58,79,15.85951361,2,13,5,35,7,1.067646459,2.075979225,137,18
E1200,HR,61,63,13.12870735,1,9,6,21,7,1.06166825,1.48633555,124,15
E1201,Marketing,42,79,13.14893362,1,5,5,19,5,0.706767045,1.342857385,121,10
E1202,HR,49,62,7.181516667,-1,4,5,29,9,1.100040538,3.544575068,111,9
E1203,Finance,60,75,14.35450476,1,8,7,20,6,0.976912003,1.302549337,135,15
E1204,Engineering,65,61,7.549175472,-1,3,9,20,1,1.403644134,2.33940689,126,12
E1205,Finance,52,73,10.27464357,0,6,4,12,6,0.886945999,1.064335198,125,10
E1206,Operations,51,70,12.0840773,1,8,6,16,9,1.07000285,1.2228604,121,14
E1207,Marketing,43,69,12.49865973,1,9,2,18,7,0.814895717,1.333465719,112,11
E1208,Operations,49,62,11.48064391,0,12,3,21,1,1.201861067,1.682605494,111,15
E1209,Engineering,57,60,9.397211616,0,8,5,11,9,1.250335232,1.057975966,117,13
E1210,HR,51,66,4.457247507,-2,11,5,18,2,2.931880949,3.298366068,117,16
E1211,Engineering,50,78,10.24705842,0,11,8,28,12,1.689330605,2.489539839,128,19
E1212,Sales,48,76,3.494512913,-2,9,1,24,7,2.224935203,5.339844487,124,10
E1213,Engineering,55,63,11.70273799,1,13,2,19,7,1.180847783,1.495740526,118,15
E1214,Sales,51,67,7.064019462,-1,11,1,18,1,1.488091647,2.23213747,118,12
E1215,Engineering,44,62,9.52141346,0,6,4,20,6,0.950442641,1.900885283,106,10
E1216,Support,40,57,8.465402035,-1,14,6,18,5,2.112958322,1.90166249,97,20
E1217,Sales,44,61,11.69803692,1,13,7,26,3,1.57504661,2.047560592,105,20
E1218,Marketing,35,71,7.629688838,-1,5,5,28,2,1.158790333,3.244612932,106,10
E1219,Operations,39,60,10.76863513,0,7,7,21,6,1.189602689,1.784404034,99,14
E1220,Operations,49,74,10.55364611,0,9,3,10,12,1.038633162,0.865527635,123,12
E1221,Finance,41,78,10.19731016,0,8,3,25,10,0.982378789,2.232679067,119,11
E1222,Operations,47,81,11.17802691,0,8,3,26,6,0.903266193,2.134992819,128,11
E1223,HR,54,72,6.392539285,-1,11,5,14,2,2.164344264,1.893801231,126,16
E1224,Support,41,62,6.502333419,-1,11,9,21,6,2.665837265,2.799129128,103,20
E1225,Engineering,45,92,14.30042716,1,8,3,22,6,0.718934177,1.437868353,137,11
E1226,Finance,49,64,5.380382222,-2,13,4,19,5,2.664417179,2.977878024,113,17
E1227,HR,44,89,16.49904344,2,3,5,23,4,0.457167846,1.314357557,133,8
E1228,HR,51,70,9.586711591,0,13,8,21,4,1.983618786,1.983618786,121,21
E1229,Sales,49,59,7.448561846,-1,6,3,27,10,1.065270062,3.195810186,108,9
E1230,Operations,66,78,12.58344563,1,5,5,22,7,0.736190233,1.619618512,144,10
E1231,Marketing,53,74,8.313299845,-1,7,2,20,8,0.966359953,2.147466562,127,9
E1232,Marketing,59,60,11.01459046,0,5,3,19,10,0.66585707,1.581410541,119,8
E1233,Finance,47,60,13.7292445,1,8,4,12,2,0.814705738,0.814705738,107,12
E1234,Support,57,87,12.13976562,1,9,6,26,5,1.141572874,1.978726315,144,15
E1235,Marketing,46,60,11.27948034,0,8,4,19,12,0.977240052,1.547296749,106,12
E1236,Engineering,39,72,11.96389431,1,9,7,20,8,1.234197042,1.542746302,111,16
E1237,Marketing,59,63,10.12022193,0,3,4,15,2,0.62948384,1.348893942,122,7
E1238,Finance,62,69,12.43328394,1,6,3,20,11,0.669977649,1.488839221,131,9
E1239,Marketing,37,65,6.781665022,-1,9,3,14,9,1.542086426,1.79910083,102,12
E1240,Engineering,54,81,14.37734813,1,9,1,19,2,0.650307186,1.235583654,135,10
E1241,Sales,38,57,9.531380334,0,18,3,19,4,1.994040604,1.804131975,95,21
E1242,Support,47,78,10.53154549,0,7,7,23,4,1.214061031,1.994528836,125,14
E1243,Finance,55,59,9.059346878,0,4,5,17,1,0.894690292,1.689970552,114,9
E1244,Sales,43,70,11.81833251,1,8,3,29,10,0.85814594,2.26238475,113,11
E1245,Sales,43,73,13.1623708,1,15,5,22,1,1.412192936,1.55341223,116,20
E1246,Sales,39,60,7.0237914,-1,9,5,23,4,1.744811063,2.866475317,99,14
E1247,HR,48,55,9.792152082,0,5,5,23,10,0.926599248,2.13117827,103,10
E1248,Support,54,68,10.50956628,0,7,3,23,3,0.868842471,1.998337683,122,10
E1249,Operations,41,70,11.30897019,0,7,6,27,8,1.056140343,2.193522251,111,13
E1250,Support,53,72,9.125322641,0,5,3,26,11,0.79009828,2.567819409,125,8
E1251,HR,56,73,8.704124838,0,7,7,21,11,1.44268548,2.16402822,129,14
E1252,Operations,46,75,12.65830655,1,5,2,13,9,0.512508632,0.951801744,121,7
E1253,Support,36,88,11.52591372,0,5,6,17,2,0.878179448,1.35718642,124,11
E1254,Sales,56,76,10.64639418,0,6,3,21,11,0.772771371,1.803133199,132,9
E1255,Finance,41,80,13.74821586,1,12,5,17,6,1.1526818,1.1526818,121,17
E1256,Operations,46,65,5.986817066,-1,8,5,24,8,1.86064697,3.435040559,111,13
E1257,Engineering,53,68,12.39535806,1,4,9,18,6,0.970485443,1.343749075,121,13
E1258,Engineering,47,73,11.12088286,0,9,6,32,1,1.237533617,2.640071715,120,15
E1259,Marketing,60,77,5.635239695,-1,6,3,25,7,1.356394104,3.767761399,137,9
E1260,Operations,55,79,13.49898155,1,2,5,24,2,0.482792531,1.655288678,134,7
E1261,Finance,61,72,11.76958985,1,7,7,23,12,1.096354712,1.801154169,133,14
E1262,HR,53,70,12.17002543,1,12,5,18,6,1.29080996,1.366739958,123,17
E1263,Sales,53,62,9.089032668,0,3,5,19,3,0.792940241,1.883233073,115,8
E1264,Marketing,49,64,12.28776798,1,7,7,11,3,1.053600576,0.827829024,113,14
E1265,Engineering,42,68,7.807181914,-1,6,4,25,1,1.135436976,2.83859244,110,10
E1266,HR,43,63,5.963746287,-1,6,5,19,8,1.57960953,2.728416461,106,11
E1267,HR,53,78,9.960834012,0,8,4,16,7,1.094807201,1.459742934,131,12
E1268,Sales,65,72,12.02502758,1,9,5,19,1,1.07485377,1.458730116,137,14
E1269,Operations,49,71,13.04477681,1,2,5,18,11,0.498405926,1.281615239,120,7
E1270,Engineering,43,71,10.45207233,0,12,6,14,12,1.571767929,1.222486167,114,18
E1271,Finance,55,76,10.22060116,0,7,8,17,1,1.336826769,1.515070338,131,15
E1272,HR,60,61,13.0429614,1,11,3,16,9,0.996940717,1.139360819,121,14
E1273,Sales,42,70,8.998190674,0,7,3,17,11,1.000180965,1.700307641,112,10
E1274,Finance,49,59,8.313626591,-1,16,7,17,7,2.469499907,1.82528254,108,23
E1275,Operations,52,61,14.85471644,2,9,7,22,9,1.009163428,1.387599714,113,16
E1276,Engineering,55,84,9.166715831,0,7,3,25,11,0.983601801,2.459004502,139,10
E1277,Operations,51,71,12.74984196,1,11,4,19,11,1.090921629,1.381834064,122,15
E1278,HR,54,73,14.07889113,1,11,6,22,10,1.127403856,1.458993225,127,17
E1279,Finance,61,70,10.63001804,0,7,8,8,9,1.289765842,0.687875116,131,15
E1280,Finance,50,72,10.79155594,0,8,7,15,3,1.272096751,1.272096751,122,15
E1281,Finance,41,60,15.39341189,2,9,4,26,9,0.793001487,1.586002973,101,13
E1282,HR,55,68,6.076083184,-1,9,6,25,8,2.119816798,3.533027997,123,15
E1283,HR,38,74,6.025205218,-1,7,4,19,6,1.565790558,2.704547328,112,11
E1284,Operations,44,64,12.4466162,1,7,3,29,5,0.743681522,2.156676414,108,10
E1285,Marketing,49,74,8.773733271,0,4,4,13,5,0.818520393,1.330095639,123,8
E1286,Operations,64,64,12.58448558,1,7,4,19,5,0.809747262,1.398654361,128,11
E1287,Engineering,61,89,9.830717716,0,4,4,18,10,0.738639877,1.661939723,150,8
E1288,Sales,49,67,12.49831615,1,5,3,16,2,0.592666516,1.185333031,116,8
E1289,Finance,46,69,7.355616872,-1,10,4,18,12,1.675519619,2.15423951,115,14
E1290,Marketing,49,84,11.83936614,1,7,0,18,1,0.545198254,1.401938367,133,7
E1291,Sales,63,62,8.497103925,-1,10,5,19,2,1.579428857,2.000609886,125,15
E1292,Marketing,40,62,12.16069218,1,13,6,14,3,1.443693063,1.063773836,102,19
E1293,Support,47,71,17.09378946,2,14,3,29,9,0.939548901,1.60275989,118,17
E1294,Operations,55,80,7.586521822,-1,8,4,21,11,1.397539102,2.445693429,135,12
E1295,HR,46,73,8.937736196,0,10,6,22,7,1.610024626,2.21378386,119,16
E1296,Finance,69,73,9.616772458,0,15,8,11,4,2.166383436,1.036096426,142,23
E1297,Operations,39,69,10.96825316,0,10,5,16,10,1.253315734,1.336870117,108,15
E1298,Sales,44,85,3.125948901,-2,9,6,19,11,3.635527332,4.605001287,129,15
E1299,Support,58,71,10.09971736,0,5,6,25,5,0.991016226,2.252309604,129,11
E1300,Support,32,70,9.344551093,0,9,8,11,2,1.643377257,1.063361755,102,17
E1301,Support,63,87,9.365673437,0,4,4,17,3,0.771778124,1.640028514,150,8
E1302,Sales,39,61,10.88360342,0,14,2,15,7,1.346392961,1.262243401,100,16
E1303,Sales,46,82,11.06221704,0,10,5,24,2,1.243552488,1.98968398,128,15
E1304,Sales,48,73,11.01574873,0,5,6,26,3,0.915465215,2.163826873,121,11
E1305,Sales,53,74,6.768865692,-1,6,3,23,6,1.158470278,2.960535156,127,9
E1306,Support,29,69,9.248821487,0,11,4,19,5,1.463582912,1.853871689,98,15
E1307,Support,53,62,9.122887028,0,6,3,27,11,0.889074429,2.667223286,115,9
E1308,Marketing,53,77,11.58188016,1,4,5,31,11,0.715314395,2.463860695,130,9
E1309,Operations,40,58,7.101733696,-1,5,5,28,2,1.234303715,3.456050402,98,10
E1310,Finance,41,66,10.58010636,0,8,7,17,3,1.29532489,1.468034876,107,15
E1311,HR,31,77,14.82657397,2,9,7,15,5,1.010957901,0.947773032,108,16
E1312,Support,54,56,2.017410761,-3,11,6,20,8,5.633969434,6.628199335,110,17
E1313,HR,47,64,9.49027125,0,4,5,25,11,0.857937777,2.383160493,111,9
E1314,Operations,57,87,4.045503321,-2,8,3,16,2,2.180159104,3.171140515,144,11
E1315,Operations,43,85,10.00082148,0,14,5,22,10,1.727143744,1.99985065,128,19
E1316,HR,45,73,12.50639078,1,7,9,28,3,1.184624395,2.073092691,118,16
E1317,Support,50,72,8.467259378,-1,17,4,18,4,2.218170979,1.90128941,122,21
E1318,HR,54,75,12.7781802,1,10,7,21,1,1.23383493,1.524149031,129,17
E1319,Marketing,47,56,14.0825173,1,11,8,23,8,1.259736662,1.52494438,103,19
E1320,Engineering,61,67,11.20532486,0,11,6,16,5,1.392834701,1.310903248,128,17
E1321,Support,57,90,8.455081149,-1,9,8,20,2,1.79797505,2.115264765,147,17
E1322,Support,40,65,11.60801281,1,9,5,29,10,1.110404963,2.300124566,105,14
E1323,Finance,43,47,15.04267227,2,8,6,20,12,0.872672567,1.246675096,90,14
E1324,Sales,57,75,6.006579429,-1,5,5,21,4,1.427229949,2.997182892,132,10
E1325,Engineering,59,70,13.32446272,1,8,5,21,10,0.907538402,1.466023572,129,13
E1326,Operations,52,58,6.133250314,-1,9,6,13,11,2.102828211,1.822451117,110,15
E1327,Support,53,80,5.447276518,-2,8,7,22,11,2.326563776,3.412293538,133,15
E1328,HR,52,64,6.299440249,-1,8,3,19,5,1.506964866,2.602939315,116,11
E1329,Engineering,29,65,9.881840905,0,5,5,22,1,0.918962158,2.021716747,94,10
E1330,Finance,52,53,13.78897401,1,10,9,18,4,1.284740915,1.217122972,105,19
E1331,Operations,43,59,3.966782469,-2,9,6,20,2,3.020063813,4.02675175,102,15
E1332,Sales,59,67,12.96862048,1,4,8,19,6,0.859068368,1.360191583,126,12
E1333,Sales,54,44,9.540686309,0,9,9,14,7,1.707668692,1.32818676,98,18
E1334,Finance,45,74,6.691335282,-1,9,4,19,8,1.690213665,2.47031228,119,13
E1335,Finance,62,75,11.77472811,1,9,5,23,6,1.095913735,1.800429708,137,14
E1336,HR,38,57,8.575505946,0,9,6,20,5,1.56649686,2.08866248,95,15
E1337,Support,39,61,16.77670857,2,4,4,24,9,0.450027066,1.350081198,100,8
E1338,Sales,61,75,11.49538633,0,7,7,25,12,1.120413537,2.00073846,136,14
E1339,Operations,39,78,10.16786271,0,9,7,18,3,1.432682368,1.611767664,117,16
E1340,Engineering,46,72,11.9446563,1,5,9,11,3,1.081527364,0.8497715,118,14
E1341,Operations,57,65,14.03057008,1,4,4,22,4,0.532248608,1.463683672,122,8
E1342,Marketing,48,58,14.3224895,1,8,4,18,5,0.783162553,1.17474383,106,12
E1343,Marketing,45,62,12.78411578,1,12,10,27,5,1.596039989,1.95877635,107,22
E1344,Finance,40,70,14.13039863,1,8,6,18,5,0.925289567,1.189658015,110,14
E1345,HR,59,55,13.60979494,1,9,5,14,10,0.958261225,0.958261225,114,14
E1346,Marketing,38,89,12.72787322,1,5,4,17,8,0.65560046,1.238356425,127,9
E1347,Sales,49,65,8.817050532,0,12,3,23,11,1.527953834,2.342862546,114,15
E1348,Operations,47,60,13.77171235,1,5,4,24,10,0.609272628,1.624727008,107,9
E1349,Operations,52,67,8.714080556,0,8,3,20,1,1.132376856,2.058867011,119,11
E1350,Finance,47,60,10.79070954,0,15,5,20,6,1.696250759,1.696250759,107,20
E1351,Support,47,76,8.871525431,0,14,5,11,3,1.924727858,1.114316128,123,19
E1352,Support,51,50,12.02194442,1,9,3,22,4,0.921521365,1.689455836,101,12
E1353,Engineering,64,74,13.83868804,1,12,5,13,5,1.145653844,0.876088234,138,17
E1354,Finance,52,70,8.779403728,0,9,10,26,9,1.94285874,2.658648802,122,19
E1355,Engineering,56,61,5.764808642,-1,8,5,20,8,1.921709939,2.956476829,117,13
E1356,Support,56,65,13.03161533,1,8,11,17,4,1.354085011,1.211549747,121,19
E1357,Finance,49,67,13.1067972,1,6,3,26,8,0.637990316,1.843083134,116,9
E1358,Finance,54,67,14.69339471,2,7,3,23,7,0.637210762,1.465584753,121,10
E1359,Finance,45,76,12.6816773,1,9,5,25,10,1.02326635,1.82726134,121,14
E1360,Support,46,86,12.75091064,1,6,3,19,2,0.654502108,1.381726672,132,9
E1361,Engineering,46,61,7.847741951,-1,5,6,23,5,1.243255066,2.599533319,107,11
E1362,Engineering,43,72,12.21108692,1,9,2,18,8,0.832633989,1.362491982,115,11
E1363,Finance,45,86,16.4404832,2,10,7,20,4,0.974743635,1.146757218,131,17
E1364,Marketing,37,94,8.341023524,-1,11,6,20,11,1.819929043,2.141092991,131,17
E1365,HR,44,59,6.346052467,-1,8,6,27,5,1.905785463,3.675443393,103,14
E1366,Support,45,70,10.42168742,0,13,5,21,11,1.575949275,1.838607487,115,18
E1367,HR,52,70,12.81231915,1,7,7,20,1,1.013587932,1.44798276,122,14
E1368,HR,57,65,10.64953595,0,4,2,25,8,0.515041975,2.146008228,122,6
E1369,Engineering,43,65,15.35131304,2,6,3,19,5,0.550414513,1.161986194,108,9
E1370,Engineering,48,63,7.418856595,-1,11,4,20,4,1.781714634,2.375619512,111,15
E1371,Marketing,45,86,5.453317995,-2,6,5,17,3,1.704549506,2.634303782,131,11
E1372,HR,50,72,14.28700212,1,7,5,18,8,0.784980594,1.17747089,122,12
E1373,HR,40,73,5.776180877,-1,8,5,16,5,1.918484798,2.361212059,113,13
E1374,Finance,52,64,10.95136377,0,8,2,33,11,0.836724594,2.76119116,116,10
E1375,Engineering,46,72,14.20546296,1,4,2,23,7,0.394595023,1.512614253,118,6
E1376,HR,41,70,10.64887272,0,12,4,19,9,1.373523463,1.631059113,111,16
E1377,Operations,50,70,7.906260501,-1,6,4,24,9,1.122805694,2.694733665,120,10
E1378,Marketing,51,62,13.8168711,1,11,10,18,9,1.41730328,1.214831383,113,21
E1379,Operations,40,56,10.51235047,0,8,7,19,4,1.30294852,1.650401459,96,15
E1380,Operations,52,84,9.337378741,0,9,3,18,9,1.160835866,1.741253799,136,12
E1381,Support,40,69,14.93052192,2,5,5,19,7,0.627725824,1.192679066,109,10
E1382,Support,53,80,8.871563397,0,5,8,20,9,1.316913996,2.026021532,133,13
E1383,Marketing,60,53,8.201987764,-1,4,7,15,7,1.195393895,1.630082585,113,11
E1384,Operations,46,71,7.29178061,-1,5,6,18,5,1.326614936,2.17082444,117,11
E1385,HR,53,59,13.64812436,1,11,6,34,10,1.160558143,2.321116286,112,17
E1386,Engineering,40,62,11.28293895,0,11,8,26,5,1.546861064,2.116757245,102,19
E1387,Marketing,51,84,8.537579432,0,9,4,19,7,1.363029277,1.992119713,135,13
E1388,Finance,40,76,5.68305727,-1,8,6,17,4,2.094849623,2.54374597,116,14
E1389,Operations,39,66,14.22616703,1,9,5,27,12,0.91946975,1.77326309,105,14
E1390,Marketing,42,68,8.581671032,0,9,5,17,6,1.461123008,1.774220795,110,14
E1391,Sales,42,83,4.542436831,-2,5,8,16,8,2.345538686,2.886816844,125,13
E1392,Sales,50,64,10.26203868,0,6,3,22,1,0.799144831,1.953465143,114,9
E1393,Support,43,88,13.09803424,1,11,7,19,12,1.276773747,1.347705622,131,18
E1394,Engineering,50,67,12.16039556,1,7,4,29,3,0.835841138,2.203581182,117,11
E1395,HR,60,70,10.24359126,0,9,7,18,3,1.423032876,1.600911985,130,16
E1396,Engineering,49,60,8.674613165,0,6,3,21,11,0.930269753,2.170629424,109,9
E1397,Engineering,51,84,8.318103874,-1,5,4,25,5,0.965861738,2.682949271,135,9
E1398,Engineering,46,77,13.82792788,1,8,8,14,2,1.079044903,0.94416429,123,16
E1399,Engineering,45,67,4.141582541,-2,4,6,14,10,1.944926474,2.722897063,112,10
E1400,Finance,42,68,7.1524654,-1,12,2,11,2,1.717271931,1.349285089,110,14
E1401,Finance,51,65,9.712509424,0,10,3,19,5,1.213534522,1.773627378,116,13
E1402,Support,55,70,4.017043602,-2,12,6,13,3,3.587770294,2.591167435,125,18
E1403,Marketing,50,75,9.346144193,0,5,6,19,1,1.063198018,1.83643294,125,11
E1404,Sales,48,83,6.319111663,-1,6,3,18,6,1.229657425,2.45931485,131,9
E1405,Engineering,38,65,11.42437757,0,6,3,17,4,0.724382364,1.368277799,103,9
E1406,Support,39,76,8.280418262,-1,9,7,15,7,1.724060225,1.616306461,115,16
E1407,Marketing,52,84,8.800816165,0,5,3,10,7,0.816258551,1.020323189,136,8
E1408,Sales,60,78,8.070859894,-1,9,4,27,9,1.433160709,2.97656455,138,13
E1409,Operations,45,80,12.02866777,1,14,9,23,12,1.765337824,1.765337824,125,23
E1410,HR,63,55,9.793265745,0,7,5,25,4,1.111804368,2.3162591,118,12
E1411,Finance,46,73,12.83816071,1,6,8,17,12,1.011695145,1.228486961,119,14
E1412,Operations,54,70,13.62387453,1,9,7,19,2,1.094101291,1.299245283,124,16
E1413,Sales,63,73,9.138867483,0,8,4,26,9,1.183564143,2.564388976,136,12
E1414,Operations,45,72,7.908675074,-1,11,6,21,10,1.908252334,2.357252883,117,17
E1415,HR,51,76,8.743141729,0,9,2,21,5,1.12899928,2.155362262,127,11
E1416,Support,56,68,17.98547115,3,10,2,24,9,0.632062271,1.264124541,124,12
E1417,Sales,48,49,8.147563487,-1,6,8,17,7,1.530462185,1.858418367,97,14
E1418,Operations,47,57,9.475793333,0,8,5,15,6,1.240956134,1.431872463,104,13
E1419,Finance,37,58,10.64339121,0,10,8,21,2,1.545941357,1.803598249,95,18
E1420,Finance,50,70,11.63970596,1,6,7,17,3,1.028504939,1.344967997,120,13
E1421,Marketing,42,71,10.31010282,0,8,3,12,12,0.972581786,1.060998312,113,11
E1422,Operations,48,65,15.32182474,2,7,4,16,11,0.673944254,0.980282552,113,11
E1423,Engineering,53,83,10.70790622,0,8,4,12,4,1.024948421,1.024948421,136,12
E1424,Operations,44,58,9.552148181,0,8,6,11,4,1.326744068,1.042441767,102,14
E1425,Support,50,81,12.86763639,1,13,0,25,7,0.937434443,1.802758545,131,13
E1426,Sales,42,68,7.34010646,-1,8,4,13,11,1.438830554,1.5587331,110,12
E1427,Sales,51,76,11.61758289,1,9,6,17,8,1.188817234,1.347326199,127,15
E1428,Support,45,74,8.887530348,0,9,2,19,7,1.112512388,1.921612307,119,11
E1429,Operations,40,67,13.85691976,1,7,4,13,6,0.740395733,0.87501314,107,11
E1430,Support,60,60,14.08786768,1,4,6,22,10,0.662784179,1.458125195,120,10
E1431,HR,50,68,9.477737389,0,5,8,15,12,1.240725885,1.431606791,118,13
E1432,Support,49,72,7.388834297,-1,7,4,19,6,1.311266811,2.264915401,121,11
E1433,Finance,47,79,4.41333199,-2,4,6,15,2,1.847291099,2.770936648,126,10
E1434,Support,64,76,10.67563146,0,10,5,23,8,1.284727088,1.969914868,140,15
E1435,Sales,53,53,3.602112526,-2,10,4,22,1,3.042081201,4.780413315,106,14
E1436,Finance,56,70,9.744870964,0,5,7,23,10,1.116811923,2.140556185,126,12
E1437,Sales,52,72,8.317119689,-1,11,4,23,8,1.609939606,2.468574062,124,15
E1438,Marketing,51,59,11.67418421,1,9,6,20,8,1.183508126,1.578010834,110,15
E1439,Engineering,50,61,9.959076778,0,5,6,19,9,1.003734185,1.733722684,111,11
E1440,Sales,47,73,8.30096447,-1,7,3,19,12,1.075157316,2.042798901,120,10
E1441,Finance,41,59,12.54721007,1,3,6,18,5,0.66434343,1.328686859,100,9
E1442,Marketing,51,69,6.72610809,-1,10,7,16,5,2.200331629,2.070900357,120,17
E1443,Sales,46,66,11.68922791,1,14,3,22,6,1.339719021,1.733754027,112,17
E1444,HR,45,79,16.18652781,2,9,4,16,9,0.756406422,0.93096175,124,13
E1445,Support,54,62,12.89671485,1,7,7,19,8,1.007432343,1.367229609,116,14
E1446,Engineering,42,62,8.783668268,0,9,5,22,2,1.430956122,2.248645334,104,14
E1447,Sales,50,74,6.945029075,-1,8,7,25,12,1.887972952,3.146621587,124,15
E1448,Marketing,47,63,12.8039784,1,5,6,18,5,0.796871719,1.303971904,110,11
E1449,HR,50,60,6.32706856,-1,9,2,19,12,1.501282527,2.593124364,110,11
E1450,Operations,46,67,10.01804429,0,9,5,18,4,1.270642923,1.633683758,113,14
E1451,Marketing,43,67,12.17352676,1,7,10,19,4,1.290466882,1.442286515,110,17
E1452,Support,46,74,6.973147527,-1,7,7,23,1,1.755893761,2.884682608,120,14
E1453,Marketing,54,60,6.807600211,-1,5,6,22,10,1.408883614,2.817767228,114,11
E1454,HR,47,63,6.046388317,-1,11,6,20,7,2.412583473,2.838333498,110,17
E1455,Marketing,48,75,14.78347272,2,7,7,26,5,0.887003782,1.647292738,123,14
E1456,HR,54,54,15.09552422,2,10,4,14,10,0.869807023,0.869807023,108,14
E1457,Sales,54,81,15.05085454,2,6,3,23,9,0.56071781,1.432945513,135,9
E1458,HR,48,61,15.45225787,2,11,10,16,11,1.276420547,0.972510893,109,21
E1459,HR,48,85,8.100894829,-1,6,9,15,1,1.648189577,1.648189577,133,15
E1460,Engineering,40,76,4.562005551,-2,6,7,19,10,2.337286412,3.416033987,116,13
E1461,HR,53,54,15.10974282,2,4,4,18,10,0.496593899,1.117336273,107,8
E1462,HR,54,69,12.7875315,1,5,5,17,7,0.725292994,1.232998089,123,10
E1463,Operations,59,76,12.5463299,1,12,2,14,6,1.033490259,1.033490259,135,14
E1464,Sales,54,64,6.879936554,-1,8,2,24,2,1.269045751,3.045709802,118,10
E1465,Support,56,81,10.29115296,0,7,5,21,9,1.062778978,1.859863211,137,12
E1466,Engineering,49,68,10.47780107,0,15,5,24,10,1.742494044,2.090992853,117,20
E1467,Operations,62,68,9.810585261,0,8,7,30,8,1.387528948,2.775057897,130,15
E1468,Finance,43,69,7.449213046,-1,10,4,19,9,1.656959047,2.248730136,112,14
E1469,Sales,61,71,4.297248004,-2,8,4,21,2,2.265327202,3.964322604,132,12
E1470,Sales,53,60,7.742007525,-1,10,2,17,3,1.372682415,1.944633421,113,12
E1471,Finance,57,70,1.385602035,-3,11,5,17,6,6.706902395,7.126083795,127,16
E1472,Support,50,62,8.761364204,0,5,9,17,6,1.434225761,1.741559852,112,14
E1473,HR,62,71,8.155005049,-1,4,3,20,4,0.764609081,2.184597375,133,7
E1474,Operations,43,63,6.496823075,-1,5,5,17,11,1.333898359,2.267627211,106,10
E1475,Marketing,54,89,11.20259781,0,11,5,19,5,1.31119621,1.5570455,143,16
E1476,Engineering,55,70,8.969886148,0,4,6,23,9,1.003020481,2.306947106,125,10
E1477,Marketing,65,62,9.186535126,0,10,8,16,12,1.767038525,1.570700911,127,18
E1478,Finance,39,68,14.17297413,1,8,7,17,10,0.988599854,1.120413167,107,15
E1479,Sales,54,72,9.036776674,0,10,6,21,1,1.594137293,2.092305197,126,16
E1480,Support,60,59,11.36129237,0,10,5,19,5,1.213465352,1.537056113,119,15
E1481,Sales,45,70,6.750634678,-1,6,3,23,3,1.161195228,2.967498915,115,9
E1482,Engineering,48,56,10.76629887,0,7,6,28,6,1.104850399,2.379677783,104,13
E1483,Sales,55,71,9.692346636,0,8,9,18,2,1.589922267,1.683447106,126,17
E1484,Sales,41,71,10.27765762,0,8,4,20,5,1.064050746,1.77341791,112,12
E1485,Engineering,51,63,6.325458034,-1,15,6,15,9,2.866714942,2.04765353,114,21
E1486,Operations,49,71,6.610784214,-1,10,3,19,5,1.70810256,2.496457588,120,13
E1487,Operations,49,70,8.96148514,0,7,2,20,4,0.90347974,2.007732755,119,9
E1488,Engineering,57,65,13.9919176,1,7,9,29,4,1.067241725,1.934375626,122,16
E1489,Support,50,66,5.67921688,-1,9,1,19,10,1.497181508,2.844644865,116,10
E1490,Finance,48,68,15.0415413,2,7,5,20,10,0.748057794,1.246762991,116,12
E1491,Sales,55,67,7.880356918,-1,6,4,19,9,1.126080865,2.139553644,122,10
E1492,Support,43,77,10.24927024,0,9,8,15,9,1.511209139,1.333419829,120,17
E1493,Sales,40,78,13.00780663,1,6,4,13,9,0.713887639,0.928053931,118,10
E1494,Finance,60,64,8.933007992,0,4,4,19,6,0.805395506,1.912814327,124,8
E1495,Operations,55,62,9.269148178,0,7,3,19,1,0.973790603,1.850202146,117,10
E1496,Support,45,82,14.33956035,1,11,5,22,4,1.043054666,1.434200166,127,16
E1497,HR,41,56,13.28987584,1,7,7,24,10,0.979714601,1.679510744,97,14
E1498,HR,52,74,12.10189226,1,12,6,17,2,1.373847353,1.2975225,126,18
E1499,HR,55,71,9.562101488,0,10,5,18,10,1.420171925,1.70420631,126,15
E1500,Operations,56,62,9.770774355,0,6,4,21,10,0.928438353,1.949720541,118,10
E1501,Operations,42,76,6.783088883,-1,7,1,13,7,1.027869541,1.670288005,118,8
E1502,Finance,44,78,9.147598948,0,5,8,17,8,1.281091228,1.675273145,122,13
E1503,Sales,37,86,10.20214635,0,11,3,28,12,1.249760498,2.499520996,123,14
E1504,Finance,53,78,9.899227149,0,5,4,18,8,0.825746622,1.651493244,131,9
E1505,Finance,54,68,10.88830029,0,8,5,17,9,1.093512081,1.429977337,122,13
E1506,Operations,44,53,13.33442336,1,7,6,17,9,0.906907775,1.185956322,97,13
E1507,HR,43,69,5.46590077,-2,11,8,27,4,2.938492358,4.175752298,112,19
E1508,Marketing,49,57,8.100256396,-1,7,8,14,11,1.648305207,1.538418193,106,15
E1509,Sales,52,69,13.43333242,1,9,6,20,9,1.039261036,1.385681381,121,15
E1510,Operations,39,70,17.39861825,2,6,5,18,4,0.597870984,0.978334338,109,11
E1511,HR,50,73,6.778835981,-1,13,3,26,6,2.056863011,3.342402393,123,16
E1512,Support,36,58,8.12388291,-1,7,4,22,8,1.205627046,2.411254092,94,11
E1513,Marketing,44,75,6.074093219,-1,9,2,12,4,1.554969614,1.696330488,119,11
E1514,Marketing,50,53,3.89036817,-2,11,2,25,7,2.658286564,5.112089547,103,13
E1515,Operations,58,73,10.82344722,0,5,8,14,5,1.099510131,1.184087834,131,13
E1516,Engineering,45,69,11.78273058,1,4,4,19,8,0.625844373,1.486380385,114,8
E1517,Sales,55,86,9.10111338,0,8,6,22,12,1.385985829,2.177977731,141,14
E1518,Marketing,49,76,9.128333779,0,4,5,21,7,0.888596308,2.073391385,125,9
E1519,Operations,51,57,9.666675145,0,9,8,17,10,1.593748733,1.593748733,108,17
E1520,Operations,56,72,8.294154417,-1,5,3,15,11,0.860756088,1.613917666,128,8
E1521,HR,51,62,9.869260649,0,8,6,22,8,1.288036091,2.024056715,113,14
E1522,Support,55,64,14.16067908,1,9,6,16,8,0.989401591,1.055361697,119,15
E1523,Engineering,47,65,7.51785867,-1,8,3,15,8,1.291404381,1.761005974,112,11
E1524,Sales,72,71,9.150872895,0,8,6,24,7,1.379191735,2.364328689,143,14
E1525,Finance,45,56,9.617066791,0,5,5,17,11,0.94187973,1.601195541,101,10
E1526,Support,58,64,8.297489731,-1,7,3,21,4,1.075559134,2.258674181,122,10
E1527,Support,45,75,10.20377693,0,7,11,16,7,1.60660107,1.42808984,120,18
E1528,HR,54,67,2.500122068,-3,10,1,17,4,3.142747534,4.856973462,121,11
E1529,Marketing,48,60,11.71874214,1,7,6,22,10,1.022113653,1.729730798,108,13
E1530,Marketing,60,80,7.083384378,-1,3,5,31,12,0.989684472,3.835027329,140,8
E1531,HR,41,74,7.478060282,-1,13,2,23,4,1.769272629,2.712884697,115,15
E1532,Operations,45,67,9.49751238,0,12,7,23,7,1.809952617,2.190995273,112,19
E1533,Marketing,45,80,5.830908081,-1,11,8,12,7,2.781474992,1.756721047,125,19
E1534,Engineering,62,56,13.9936188,1,7,3,20,3,0.666950396,1.333900793,118,10
E1535,Sales,59,69,7.528459207,-1,5,3,28,1,0.938035794,3.283125278,128,8
E1536,Support,39,61,17.89807444,3,10,6,19,9,0.846647104,1.005393436,100,16
E1537,Support,53,77,11.89060063,1,7,6,19,1,1.008486755,1.47394218,130,13
E1538,Engineering,43,73,8.295118405,-1,9,10,27,6,2.044083698,2.904750518,116,19
E1539,Marketing,55,83,9.080808575,0,13,2,22,2,1.487975879,2.182364623,138,15
E1540,Support,49,57,10.44577322,0,7,3,19,6,0.873684967,1.660001438,106,10
E1541,Finance,55,66,15.09616136,2,13,6,19,12,1.180405661,1.180405661,121,19
E1542,Sales,38,60,12.85085871,1,10,2,19,1,0.866372277,1.371756105,98,12
E1543,Sales,59,70,12.62576335,1,9,2,16,2,0.807294221,1.174246139,129,11
E1544,Support,40,67,9.083288116,0,10,7,19,10,1.685957974,1.884305971,107,17
E1545,HR,44,69,8.299220742,-1,11,1,11,5,1.290430707,1.182894815,113,12
E1546,Support,59,64,11.91221503,1,8,2,25,1,0.774460461,1.936151152,123,10
E1547,HR,36,61,14.00071162,1,12,6,19,2,1.199943073,1.266606577,97,18
E1548,Support,51,84,9.585910989,0,9,6,15,4,1.416977718,1.416977718,135,15
E1549,Finance,54,83,7.945988665,-1,6,8,22,10,1.56494721,2.459202758,137,14
E1550,Operations,44,65,6.900113108,-1,5,3,19,7,1.012643729,2.405028857,109,8
E1551,Sales,55,45,4.979475962,-2,7,5,26,9,2.006864828,4.348207128,100,12
E1552,Support,50,72,8.659580619,0,4,6,22,11,1.035241631,2.277531589,122,10
E1553,Finance,45,76,9.236830385,0,9,9,19,4,1.758356769,1.856043256,121,18
E1554,HR,45,89,9.93980809,0,14,2,29,1,1.462548508,2.650869171,134,16
E1555,HR,60,88,11.62491779,1,7,3,24,2,0.792084366,1.901002478,148,10
E1556,Sales,52,75,8.593696715,0,6,3,20,1,0.93811596,2.084702133,127,9
E1557,Engineering,54,67,15.38585349,2,11,4,14,10,0.915423783,0.854395531,121,15
E1558,Support,57,64,6.583916474,-1,6,8,17,10,1.846011892,2.241585869,121,14
E1559,Marketing,53,84,12.04830964,1,11,5,17,12,1.226212471,1.30285075,137,16
E1560,HR,55,64,6.341325696,-1,8,3,27,7,1.498366978,3.677809856,119,11
E1561,Operations,49,72,7.448633631,-1,13,6,21,10,2.248884356,2.485609025,121,19
E1562,Operations,58,77,10.8430024,0,6,7,16,11,1.097694618,1.351008761,135,13
E1563,HR,47,73,13.1310231,1,9,3,20,1,0.849195413,1.415325689,120,12
E1564,Engineering,50,69,9.161369661,0,3,3,20,9,0.59047158,1.9682386,119,6
E1565,Engineering,50,78,10.25384192,0,8,11,25,7,1.688312323,2.221463583,128,19
E1566,Finance,47,78,13.78819687,1,12,3,25,10,1.014322444,1.690537407,125,15
E1567,Operations,45,59,6.33356862,-1,5,3,14,10,1.090874091,1.909029659,104,8
E1568,Finance,47,74,12.30964821,1,13,6,27,4,1.427535853,2.02860358,121,19
E1569,Operations,54,62,7.932802433,-1,5,7,22,4,1.343363417,2.462832931,116,12
E1570,Support,50,54,10.72928734,0,12,6,23,2,1.534620091,1.960903449,104,18
E1571,Support,61,68,11.61920951,1,5,3,23,8,0.633954131,1.822618126,129,8
E1572,Marketing,49,79,6.472771106,-1,9,4,13,6,1.739649163,1.739649163,128,13
E1573,Support,65,80,7.760319848,-1,8,4,22,2,1.369812999,2.511323831,145,12
E1574,Marketing,50,68,11.99757357,1,10,5,21,6,1.154061557,1.61568618,118,15
E1575,Support,45,60,9.219668274,0,10,5,19,6,1.467758013,1.85916015,105,15
E1576,Sales,61,63,7.859015233,-1,6,8,32,8,1.580311088,3.612139629,124,14
E1577,Support,43,78,10.58419676,0,9,6,24,11,1.294867509,2.071788014,121,15
E1578,Finance,52,78,6.761746894,-1,12,6,15,9,2.319065572,1.932554643,130,18
E1579,HR,54,60,6.452077888,-1,6,3,23,8,1.207716846,3.086387494,114,9
E1580,Finance,53,76,2.834872982,-2,5,6,23,5,2.868413126,5.997591083,129,11
E1581,HR,48,69,11.07936989,0,6,3,22,9,0.745071977,1.821287054,117,9
E1582,Engineering,46,74,10.09597623,0,12,4,19,4,1.441964156,1.712332436,120,16
E1583,Finance,53,72,11.6217703,1,9,10,24,6,1.505335587,1.901476531,125,19
E1584,Engineering,45,60,13.66557775,1,9,4,21,3,0.886429449,1.431924494,105,13
E1585,Marketing,47,86,9.276065636,0,6,4,16,10,0.973135084,1.557016135,133,10
E1586,Marketing,49,65,9.791368587,0,11,3,16,9,1.297333131,1.482666436,114,14
E1587,Sales,51,63,11.02963511,0,7,5,20,9,0.997536491,1.662560818,114,12
E1588,Support,65,75,8.289767664,-1,7,5,20,6,1.291743823,2.152906372,140,12
E1589,Finance,49,87,5.626872932,-1,9,6,16,11,2.263511034,2.414411769,136,15
E1590,Engineering,45,51,6.545186137,-1,7,4,22,7,1.457883185,2.915766371,96,11
E1591,HR,54,62,9.880549579,0,7,4,17,8,1.010978344,1.562421078,116,11
E1592,Marketing,52,76,12.99937386,1,10,5,17,4,1.071476493,1.214340025,128,15
E1593,Support,39,66,14.70197108,2,7,4,18,1,0.700548991,1.146352895,105,11
E1594,Marketing,45,71,9.145891628,0,11,5,20,9,1.576992992,1.971241241,116,16
E1595,HR,43,90,10.50353829,0,8,5,20,3,1.130087081,1.738595509,133,13
E1596,Support,48,83,15.61242094,2,10,7,30,5,1.023330679,1.805877669,131,17
E1597,Support,49,76,11.55046275,1,7,4,20,3,0.876461707,1.59356674,125,11
E1598,Engineering,48,70,10.41165317,0,11,13,16,4,2.103113338,1.402075559,118,24
E1599,Engineering,50,79,10.63047717,0,8,3,21,9,0.945790946,1.805600896,129,11
E1600,Finance,51,67,11.74588385,1,6,2,21,10,0.627653609,1.647590724,118,8
E1601,Finance,57,71,6.339102535,-1,12,3,13,2,2.043846632,1.771333748,128,15
E1602,Operations,57,73,12.28162859,1,9,7,23,2,1.204671543,1.731715342,130,16
E1603,Operations,48,70,11.31734827,0,8,9,17,3,1.380167194,1.380167194,118,17
E1604,Sales,45,73,13.26471124,1,9,4,15,4,0.911339864,1.051545997,118,13
E1605,Marketing,59,74,11.48236452,0,8,6,22,2,1.121582371,1.762486584,133,14
E1606,Finance,58,65,13.06374564,1,6,2,34,9,0.568838502,2.417563633,123,8
E1607,Engineering,52,51,7.231373005,-1,3,2,20,5,0.607432077,2.429728307,103,5
E1608,HR,59,64,8.210709445,-1,4,4,23,3,0.868554159,2.497093208,123,8
E1609,Engineering,45,66,10.45812093,0,7,6,18,4,1.134566487,1.570938212,111,13
E1610,Marketing,56,65,7.74636954,-1,4,9,28,12,1.486330979,3.201328262,121,13
E1611,Operations,50,71,12.56645898,1,7,6,16,2,0.958245628,1.179379234,121,13
E1612,Engineering,48,56,5.753387533,-1,6,3,17,10,1.332664527,2.517255217,104,9
E1613,Sales,54,77,9.521215519,0,8,5,23,1,1.235598679,2.186059202,131,13
E1614,Marketing,48,60,8.300517501,-1,8,3,21,12,1.182729886,2.257938872,108,11
E1615,Operations,45,72,7.772736825,-1,4,6,17,5,1.139895132,1.937821724,117,10
E1616,HR,55,67,5.887038032,-1,11,3,16,12,2.032804224,2.323204827,122,14
E1617,Operations,52,69,10.12540142,0,5,4,23,6,0.808959575,2.067341136,121,9
E1618,Support,46,67,9.750677424,0,9,4,20,11,1.209226125,1.860347884,113,13
E1619,Sales,48,72,15.71315524,2,7,9,20,11,0.957329706,1.196662133,120,16
E1620,Marketing,57,74,17.46376122,2,14,4,18,12,0.974882625,0.974882625,131,18
E1621,HR,44,64,6.796098164,-1,9,3,22,2,1.539231517,2.821924447,108,12
E1622,Sales,47,76,4.290956788,-2,11,3,15,10,2.646024256,2.835025989,123,14
E1623,Operations,49,88,6.398026516,-1,8,5,17,2,1.757225386,2.29791012,137,13
E1624,Sales,41,65,9.81442108,0,5,7,17,6,1.109629439,1.571975039,106,12
E1625,Marketing,42,50,13.37551255,1,8,4,22,10,0.834752845,1.530380216,92,12
E1626,Finance,44,70,8.555613124,0,6,7,23,10,1.36045692,2.406962243,114,13
E1627,Sales,52,79,11.73483341,1,8,3,19,6,0.863772587,1.491970832,131,11
E1628,Support,60,60,7.602877658,-1,9,5,19,1,1.627362443,2.208563315,120,14
E1629,Sales,56,57,8.538632668,0,10,4,25,7,1.467715603,2.62092072,113,14
E1630,Operations,51,65,10.50038986,0,8,4,14,12,1.043442887,1.217350035,116,12
E1631,Operations,49,66,9.966596073,0,5,10,14,11,1.36778996,1.276603962,115,15
E1632,HR,42,76,9.89182488,0,5,2,19,3,0.642683855,1.744427606,118,7
E1633,Operations,54,70,6.754603012,-1,8,4,17,5,1.547467998,2.192246331,124,12
E1634,Engineering,60,70,13.67768143,1,16,5,29,8,1.430743684,1.975788897,130,21
E1635,Marketing,41,54,13.65499424,1,9,8,26,6,1.160014103,1.774139216,95,17
E1636,Marketing,57,63,13.7052528,1,6,4,10,8,0.680029112,0.680029112,120,10
E1637,Finance,59,80,7.968326947,-1,6,5,23,12,1.226538692,2.564580901,139,11
E1638,Finance,60,75,10.35817065,0,13,2,19,1,1.320635203,1.672804591,135,15
E1639,Marketing,55,61,8.425375551,-1,8,7,13,11,1.591448523,1.379255387,116,15
E1640,Support,50,73,7.07584988,-1,5,8,22,8,1.609737699,2.72417149,123,13
E1641,Finance,42,68,10.85488924,0,14,13,16,3,2.277541312,1.349654111,110,27
E1642,HR,62,71,3.632984731,-2,13,3,22,8,3.453497244,4.748558711,133,16
E1643,Operations,36,71,12.54052046,1,8,8,19,9,1.181638479,1.403195694,107,16
E1644,Marketing,52,66,6.511906591,-1,8,2,21,3,1.331219961,2.795561918,118,10
E1645,Finance,51,60,9.060956514,0,8,0,26,4,0.795153024,2.584247329,111,8
E1646,Marketing,52,80,3.192629193,-2,12,3,24,4,3.577707283,5.724331653,132,15
E1647,Engineering,45,65,15.42327283,2,7,6,15,11,0.791559644,0.913338051,110,13
E1648,Sales,57,64,11.97467314,1,9,5,14,2,1.079025255,1.079025255,121,14
E1649,Operations,52,58,10.2576153,0,5,5,19,9,0.888287593,1.687746427,110,10
E1650,Marketing,42,68,7.93560717,-1,5,3,28,12,0.895294505,3.133530768,110,8
E1651,Sales,46,76,6.802819794,-1,7,7,22,9,1.794223162,2.81949354,122,14
E1652,Finance,41,83,9.399072082,0,8,5,21,11,1.250111539,2.019410947,124,13
E1653,Sales,51,64,10.90663289,0,4,1,18,11,0.419934002,1.511762407,115,5
E1654,Operations,45,85,9.310470455,0,12,5,25,10,1.648809341,2.42471962,130,17
E1655,Marketing,59,80,11.59275928,1,7,5,11,7,0.952928562,0.873517849,139,12
E1656,Engineering,48,66,15.56718844,2,10,5,13,11,0.905404079,0.784683535,114,15
E1657,Support,40,71,6.780540159,-1,8,6,20,7,1.799360933,2.570515619,111,14
E1658,Finance,54,76,10.70945818,0,7,5,23,10,1.024812576,1.964224104,130,12
E1659,Marketing,43,74,15.22364742,2,17,4,17,8,1.294406828,1.047853147,117,21
E1660,Operations,39,71,9.067738156,0,9,4,27,3,1.291253288,2.681833753,110,13
E1661,Finance,53,77,9.582876056,0,5,7,18,2,1.133907261,1.700860891,130,12
E1662,HR,51,82,11.38378016,0,13,5,20,4,1.453514175,1.61501575,133,18
E1663,Sales,58,79,12.02829187,1,10,6,13,1,1.228096527,0.997828428,137,16
E1664,Support,42,52,13.14930985,1,8,2,25,7,0.706748252,1.766870629,94,10
E1665,Operations,35,62,10.32783351,0,5,4,16,8,0.794503203,1.412450138,97,9
E1666,HR,57,66,7.615431736,-1,8,5,21,6,1.508920319,2.437486668,123,13
E1667,Marketing,35,77,11.6822878,1,12,9,22,12,1.655852661,1.734702787,112,21
E1668,Engineering,64,77,7.09925752,-1,12,7,25,12,2.345894047,3.086702693,141,19
E1669,Finance,57,72,10.99587357,0,11,5,13,11,1.333791983,1.083705987,129,16
E1670,Sales,63,62,10.23175358,0,9,3,17,10,1.068399508,1.51356597,125,12
E1671,Finance,55,76,10.15821867,0,2,5,19,1,0.627340278,1.702780753,131,7
E1672,Support,36,73,9.753107708,0,7,7,26,7,1.301949202,2.417905661,109,14
E1673,Marketing,45,76,13.00571548,1,4,1,24,10,0.356997114,1.713586146,121,5
E1674,Finance,48,90,11.85412334,1,8,7,33,2,1.166940724,2.567269594,138,15
E1675,Sales,64,73,12.08370418,1,7,5,16,3,0.917171455,1.222895273,137,12
E1676,Marketing,48,69,8.609055108,0,7,7,27,11,1.456959071,2.809849636,117,14
E1677,Finance,54,85,5.073763718,-2,8,4,21,5,1.975710706,3.457493735,139,12
E1678,Engineering,52,65,8.80862917,0,6,5,19,6,1.121461502,1.937069867,117,11
E1679,Operations,55,84,11.307265,0,15,8,17,10,1.868814883,1.381297957,139,23
E1680,Marketing,50,75,10.09719293,0,8,9,21,10,1.531918937,1.892370452,125,17
E1681,Operations,58,59,8.701676695,0,14,5,25,11,1.958424363,2.576874162,117,19
E1682,Marketing,50,89,10.66429275,0,13,3,19,6,1.371707684,1.628902875,139,16
E1683,Engineering,59,70,9.198424358,0,7,3,15,7,0.980543626,1.470815439,129,10
E1684,Operations,48,59,10.1463978,0,11,10,23,6,1.884016735,2.063446901,107,21
E1685,HR,52,72,4.033583519,-2,10,3,20,8,2.582653084,3.973312437,124,13
E1686,Sales,50,61,12.30143147,1,6,3,21,9,0.676618905,1.578777445,111,9
E1687,HR,47,49,11.83847109,1,9,8,22,12,1.32414521,1.713599684,96,17
E1688,Finance,59,66,16.33674755,2,7,5,37,7,0.692171352,2.134195004,125,12
E1689,Engineering,44,84,7.864197642,-1,7,6,28,11,1.466573798,3.158774334,128,13
E1690,HR,55,79,8.490420668,-1,8,7,25,7,1.580541108,2.63423518,134,15
E1691,Marketing,46,81,10.52279135,0,11,3,21,3,1.214983381,1.822475072,127,14
E1692,Finance,45,79,9.897674003,0,10,6,27,2,1.468203214,2.477592924,124,16
E1693,Finance,55,66,14.73959936,2,14,4,17,12,1.143612337,1.080078318,121,18
E1694,HR,46,59,8.775006278,0,8,5,18,7,1.32992242,1.841431042,105,13
E1695,HR,49,79,9.538829263,0,9,0,23,10,0.8539848,2.1824056,128,9
E1696,Engineering,50,63,8.313351755,-1,4,5,15,7,0.966354567,1.610590945,113,9
E1697,Sales,28,67,14.57086913,2,5,5,12,11,0.642224909,0.77066989,95,10
E1698,HR,37,57,11.46158912,0,6,1,18,4,0.561726112,1.444438573,94,7
E1699,Support,59,56,14.71265762,2,5,3,20,7,0.50914366,1.272859149,115,8
E1700,HR,64,59,18.7451903,3,9,4,26,7,0.658388185,1.316776369,123,13
E1701,Operations,58,62,7.711556228,-1,9,5,14,11,1.60706074,1.60706074,120,14
E1702,Marketing,53,64,13.23458169,1,12,11,14,7,1.615783344,0.983520296,117,23
E1703,Support,49,52,9.229786931,0,8,3,31,9,1.075291213,3.030366146,101,11
E1704,Support,56,73,7.937074917,-1,5,5,10,11,1.118934337,1.118934337,129,10
E1705,Operations,40,67,5.601151557,-1,8,4,23,1,1.81786464,3.48424056,107,12
E1706,Operations,57,72,16.38509933,2,11,0,18,9,0.632725749,1.035369408,129,11
E1707,Finance,50,82,13.00610474,1,10,5,26,4,1.070961575,1.856333397,132,15
E1708,Sales,59,68,9.323714159,0,7,2,15,4,0.871779271,1.452965451,127,9
E1709,Marketing,56,64,11.86580355,1,9,5,22,4,1.088155897,1.709959267,120,14
E1710,Engineering,47,70,4.573072374,-2,8,4,21,5,2.153210867,3.768119018,117,12
E1711,Support,57,61,9.716857448,0,9,6,13,12,1.399664041,1.213042169,118,15
E1712,Engineering,61,69,7.714243305,-1,5,2,20,1,0.803282598,2.295093137,130,7
E1713,HR,53,64,14.33671156,1,2,4,21,4,0.391218155,1.369263542,117,6
E1714,HR,56,70,14.53836612,1,9,3,15,12,0.77228197,0.965352462,126,12
E1715,Engineering,51,75,12.67135498,1,10,3,17,6,0.950893311,1.243475868,126,13
E1716,HR,60,66,12.84208937,1,9,4,16,4,0.939164576,1.155894863,126,13
E1717,Sales,53,64,8.050397425,-1,6,5,26,5,1.215416239,2.872802019,117,11
E1718,Operations,45,63,12.15086448,1,8,5,27,1,0.98852817,2.053096969,108,13
E1719,HR,59,54,5.861850187,-1,2,4,18,10,0.874399737,2.623199212,113,6
E1720,Finance,50,66,5.45750882,-2,6,3,22,9,1.393726319,3.406886558,116,9
E1721,HR,35,77,9.68355652,0,4,3,18,7,0.655212521,1.684832197,112,7
E1722,Marketing,34,83,11.59058818,1,3,4,19,8,0.555970849,1.509063733,117,7
E1723,Sales,47,64,11.79440556,1,9,5,20,8,1.094228249,1.563183213,111,14
E1724,Marketing,46,74,6.228934994,-1,3,8,19,10,1.521662598,2.628326305,120,11
E1725,Marketing,51,72,5.345283806,-2,5,1,16,8,0.945584182,2.52155782,123,6
E1726,Finance,37,71,8.645358695,0,9,4,20,11,1.347798502,2.073536157,108,13
E1727,Sales,60,68,7.370766441,-1,10,5,13,4,1.791950606,1.553023859,128,15
E1728,Sales,57,76,11.8360527,1,7,2,21,8,0.701150129,1.636016967,133,9
E1729,Sales,61,72,6.96141297,-1,3,4,16,9,0.879240912,2.009693513,133,7
E1730,Sales,49,71,15.83290626,2,6,5,25,3,0.653481926,1.485186195,120,11
E1731,Sales,53,61,11.08708062,0,4,8,15,12,0.992795562,1.240994453,114,12
E1732,Finance,45,70,9.559220433,0,9,4,24,7,1.231151493,2.272895064,115,13
E1733,HR,50,60,6.558013064,-1,11,7,16,11,2.381578313,2.1169585,110,18
E1734,Marketing,59,74,6.036614487,-1,9,8,21,7,2.415934542,2.984389729,133,17
E1735,Sales,58,63,9.037248275,0,11,3,14,6,1.394804594,1.394804594,121,14
E1736,Support,40,83,8.26347904,-1,8,7,18,2,1.619262044,1.943114452,123,15
E1737,HR,52,62,4.804514081,-2,8,1,24,3,1.550517386,4.134713029,114,9
E1738,HR,58,61,14.11489894,1,15,5,23,7,1.323197732,1.521677392,119,20
E1739,Marketing,42,57,6.684341058,-1,9,5,19,11,1.82188686,2.472560738,99,14
E1740,Finance,47,68,11.05784071,0,6,3,21,10,0.746402297,1.741605359,115,9
E1741,Engineering,54,81,11.32661558,0,7,2,31,8,0.730127417,2.514883327,135,9
E1742,Engineering,55,72,5.143467057,-2,6,3,21,11,1.464970825,3.418265257,127,9
E1743,HR,46,74,8.84585285,0,9,6,23,12,1.523484073,2.336008912,120,15
E1744,Operations,60,77,5.771100727,-1,7,6,15,12,1.919924178,2.215297129,137,13
E1745,Operations,57,74,11.22279629,0,7,9,23,11,1.309029425,1.881729798,131,16
E1746,Marketing,47,77,10.18755069,0,8,3,16,7,0.983235768,1.430161117,124,11
E1747,Engineering,42,58,9.768152867,0,6,2,22,8,0.742931504,2.043061635,100,8
E1748,HR,48,88,7.539483119,-1,9,6,17,3,1.756546596,1.990752808,136,15
E1749,Finance,54,79,13.54311018,1,8,5,18,7,0.893894073,1.237699486,133,13
E1750,Engineering,44,68,8.866512463,0,5,4,23,12,0.912176418,2.331117513,112,9
E1751,HR,48,60,5.567958639,-1,8,8,23,6,2.436068934,3.501849093,108,16
E1752,HR,54,75,7.167124088,-1,6,7,21,3,1.59174758,2.571284552,129,13
E1753,Sales,47,72,3.978683338,-2,11,6,18,3,3.414557393,3.61541371,119,17
E1754,Finance,39,68,8.036962568,-1,11,8,14,4,2.102476342,1.549193094,107,19
E1755,Sales,44,65,7.272838485,-1,6,3,25,11,1.087897463,3.021937397,109,9
E1756,Marketing,42,72,12.08373479,1,5,5,23,1,0.764307758,1.757907842,114,10
E1757,Sales,54,72,11.71668263,1,6,5,24,6,0.865005467,1.887284655,126,11
E1758,Support,44,72,10.63798165,0,5,6,17,11,0.945181074,1.460734388,116,11
E1759,Sales,46,59,12.84136269,1,5,5,24,10,0.722472218,1.733933322,105,10
E1760,Support,54,71,6.464790589,-1,2,8,17,4,1.339622308,2.277357924,125,10
E1761,Engineering,37,70,10.95496057,0,9,5,24,10,1.171061998,2.007534853,107,14
E1762,Operations,52,65,5.685990486,-1,15,3,15,10,2.692196472,2.24349706,117,18
E1763,HR,45,83,8.569463918,0,8,1,14,12,0.940491555,1.462986863,128,9
E1764,Support,49,84,11.02355566,0,7,4,16,2,0.914870802,1.330721166,133,11
E1765,Finance,42,69,8.404709657,-1,9,8,20,9,1.807604979,2.126594093,111,17
E1766,Sales,45,70,14.89976146,2,8,5,21,5,0.817622329,1.320774532,115,13
E1767,Support,50,62,8.955892421,0,15,6,22,4,2.109303628,2.209746658,112,21
E1768,Finance,63,74,12.40236537,1,6,5,14,11,0.820750643,1.044591728,137,11
E1769,Operations,54,63,9.206415031,0,5,6,21,4,1.077753547,2.057529499,117,11
E1770,Operations,57,61,10.39500105,0,2,3,16,12,0.438788902,1.404124487,118,5
E1771,Sales,49,70,8.904905956,0,8,3,18,4,1.110560771,1.817281262,119,11
E1772,Marketing,46,59,10.53143645,0,8,8,14,5,1.387511441,1.214072511,105,16
E1773,Sales,45,66,15.17994386,2,12,3,18,3,0.927073674,1.112488409,111,15
E1774,Engineering,60,75,14.62947323,2,9,4,16,7,0.831761878,1.023706926,135,13
E1775,Support,51,65,8.538493824,0,6,10,26,6,1.677413677,2.725797225,116,16
E1776,HR,49,68,9.312984007,0,10,2,19,1,1.163581752,1.842337774,117,12
E1777,Marketing,45,84,10.1525174,0,6,2,23,4,0.717326834,2.062314649,129,8
E1778,Sales,53,56,11.92626115,1,10,3,21,5,1.005704577,1.624599701,109,13
E1779,Finance,46,64,15.56345606,2,10,3,15,3,0.784860355,0.905608102,110,13
E1780,Marketing,50,64,13.85782816,1,3,5,21,1,0.538436703,1.413396344,114,8
E1781,Support,44,70,9.199727985,0,12,4,26,4,1.568669284,2.549087587,114,16
E1782,Marketing,59,64,11.20902341,0,6,1,19,11,0.573346431,1.556226028,123,7
E1783,Support,48,66,10.67716941,0,11,4,24,11,1.284557881,2.05529261,114,15
E1784,Sales,46,63,8.182700327,-1,9,7,19,6,1.742406855,2.069108141,109,16
E1785,Support,52,74,13.04063294,1,14,4,15,11,1.281993488,1.068327907,126,18
E1786,Marketing,45,93,2.457948172,-3,8,5,22,5,3.759454842,6.362154348,138,13
E1787,Finance,56,69,13.01838808,1,12,6,26,7,1.2840278,1.854706822,125,18
E1788,Operations,33,78,11.23560579,0,9,5,16,10,1.144201622,1.307658997,111,14
E1789,Marketing,46,81,4.58062351,-2,9,2,20,4,1.971105913,3.583828933,127,11
E1790,Support,53,74,6.874694629,-1,6,3,26,2,1.142901461,3.301715333,127,9
E1791,Operations,71,67,3.802350628,-2,6,6,20,9,2.498776314,4.164627189,138,12
E1792,Support,43,77,15.09032859,2,3,10,22,6,0.807938752,1.367280965,120,13
E1793,Finance,50,80,7.025072559,-1,12,7,17,5,2.367579839,2.118360909,130,19
E1794,Support,55,81,12.73059037,1,3,6,29,1,0.655470723,2.11207233,136,9
E1795,Sales,39,66,12.83764993,1,3,5,17,5,0.578132851,1.228532308,105,8
E1796,HR,42,82,9.637987466,0,7,8,21,12,1.410041142,1.974057599,124,15
E1797,Marketing,46,73,8.006284016,-1,8,5,17,8,1.443436602,1.887570941,119,13
E1798,HR,40,54,11.53829623,0,8,3,26,10,0.87731218,2.073646971,94,11
E1799,Support,50,69,10.64627758,0,7,7,19,3,1.202100835,1.631422562,119,14
E1800,Finance,52,60,12.8087131,1,5,4,29,5,0.6517624,2.10012329,112,9
E1801,Marketing,56,84,6.480081912,-1,7,3,18,12,1.336883756,2.40639076,140,10
E1802,Support,49,70,13.06729691,1,9,4,18,3,0.924129212,1.279563524,119,13
E1803,Operations,51,69,14.04304067,1,7,6,15,12,0.864186988,0.997138832,120,13
E1804,Engineering,56,74,9.229695871,0,8,5,21,10,1.270810019,2.052846953,130,13
E1805,Support,62,67,7.132047842,-1,6,6,16,8,1.475643065,1.967524086,129,12
E1806,HR,56,88,8.550143769,0,10,7,22,12,1.780077914,2.303630242,144,17
E1807,Marketing,49,92,8.079609459,-1,11,4,18,6,1.652053436,1.982464123,141,15
E1808,HR,53,79,9.457492523,0,12,7,10,10,1.816879138,0.956252178,132,19
E1809,Marketing,50,64,7.785604931,-1,5,8,21,7,1.479693214,2.390273654,114,13
E1810,Support,46,72,11.36952353,0,10,3,25,11,1.05097015,2.021096442,118,13
E1811,Sales,44,64,11.91007413,1,7,2,20,3,0.697130002,1.549177782,108,9
E1812,Operations,57,53,8.922996843,0,10,5,24,3,1.511640106,2.41862417,110,15
E1813,Support,50,74,4.136569885,-2,9,7,20,4,3.114919169,3.893648962,124,16
E1814,HR,55,74,11.32907822,0,5,5,16,11,0.811090645,1.297745031,129,10
E1815,Engineering,55,64,5.574620448,-1,6,3,23,9,1.368900315,3.498300804,119,9
E1816,Engineering,59,67,10.7487659,0,4,6,20,12,0.851153227,1.702306453,126,10
E1817,Finance,49,75,10.21560418,0,8,5,29,7,1.159099393,2.585683262,124,13
E1818,Marketing,53,83,9.013089646,0,5,7,18,4,1.198431296,1.797646944,136,12
E1819,HR,56,67,11.93449769,1,10,6,26,10,1.237002038,2.010128311,123,16
E1820,Finance,61,68,11.09069513,0,8,7,21,3,1.240623458,1.736872841,129,15
E1821,HR,47,74,11.16304594,0,14,4,20,8,1.479892461,1.644324957,121,18
E1822,Marketing,47,67,12.46306337,1,5,3,26,10,0.594218402,1.931209805,114,8
E1823,Support,49,71,8.761535978,0,7,6,17,4,1.331757628,1.741529206,120,13
E1824,Support,41,80,8.719651859,0,7,10,30,11,1.749033839,3.086530303,121,17
E1825,Engineering,50,61,13.23166972,1,11,7,26,7,1.264784832,1.826911424,111,18
E1826,Support,49,82,11.92569043,1,13,6,18,3,1.469940821,1.392575515,131,19
E1827,Support,41,65,8.590915287,0,7,4,21,8,1.14691869,2.189572045,106,11
E1828,Sales,62,65,3.988784861,-2,9,3,16,2,2.405395369,3.207193825,127,12
E1829,Engineering,56,90,11.17612504,0,9,5,10,4,1.149791083,0.821279345,146,14
E1830,Finance,45,68,11.45772349,0,4,3,22,6,0.561900415,1.765972733,113,7
E1831,Operations,49,68,6.36282401,-1,7,2,19,6,1.222357072,2.580531597,117,9
E1832,Sales,55,70,7.454387978,-1,5,3,24,4,0.946254184,2.838762553,125,8
E1833,Finance,59,63,8.776514731,0,9,2,22,5,1.125145341,2.250290682,122,11
E1834,Marketing,62,68,11.35697624,0,7,7,21,6,1.132963253,1.699444879,130,14
E1835,Sales,50,71,17.45072854,2,8,7,20,9,0.812976028,1.083968037,121,15
E1836,Finance,56,76,13.35313799,1,9,5,24,8,0.975396461,1.672108219,132,14
E1837,Marketing,59,70,5.474674607,-2,11,5,20,12,2.471166656,3.088958321,129,16
E1838,Engineering,39,55,8.691361361,0,7,4,16,11,1.135031456,1.650954846,94,11
E1839,Operations,39,79,9.716401144,0,10,4,25,5,1.306408729,2.332872731,118,14
E1840,Marketing,49,79,11.50736481,0,9,5,26,7,1.119340502,2.078775218,128,14
E1841,Support,71,82,7.562564402,-1,6,6,21,2,1.401449313,2.452536298,153,12
E1842,HR,59,67,11.75359176,1,5,5,30,10,0.784092841,2.352278524,126,10
E1843,Marketing,51,65,8.460867704,-1,6,7,26,12,1.374081153,2.748162305,116,13
E1844,Marketing,51,84,11.74880252,1,8,3,22,1,0.862826135,1.72565227,135,11
E1845,Operations,56,87,10.22738109,0,11,2,23,9,1.157883561,2.048563223,143,13
E1846,HR,60,70,16.13629972,2,7,5,24,10,0.700267864,1.400535728,130,12
E1847,Support,41,64,12.93646512,1,10,3,27,1,0.932804688,1.937363583,105,13
E1848,Finance,42,71,13.94166345,1,9,5,18,2,0.936977335,1.204685145,113,14
E1849,Finance,54,73,6.827019742,-1,9,2,21,3,1.405388048,2.683013547,127,11
E1850,Marketing,35,70,8.403713022,-1,11,6,23,11,1.807796554,2.445842397,105,17
E1851,HR,51,71,10.98152495,0,10,3,22,8,1.085003791,1.836160262,122,13
E1852,HR,46,75,6.299814907,-1,4,4,23,6,1.095918198,3.15076482,121,8
E1853,Support,53,75,13.13615096,1,11,3,19,6,0.990368598,1.344071668,128,14
E1854,Operations,56,74,10.39143005,0,3,7,17,7,0.877852909,1.492349945,130,10
E1855,Engineering,57,61,13.29978654,1,8,3,15,9,0.769242252,1.048966707,118,11
E1856,Finance,46,52,11.44696675,0,10,3,18,12,1.044431166,1.446135461,98,13
E1857,Operations,38,74,10.13458911,0,7,4,28,4,0.987912521,2.514686417,112,11
E1858,Sales,49,72,9.631961208,0,4,6,26,8,0.940560241,2.445456628,121,10
E1859,Finance,60,65,7.693437564,-1,10,10,23,4,2.300585914,2.645673801,125,20
E1860,Operations,40,63,7.514909099,-1,6,4,13,11,1.174410658,1.526733856,103,10
E1861,Finance,28,73,12.66599794,1,6,5,22,4,0.804917434,1.609834868,101,11
E1862,Engineering,53,75,12.00405767,1,14,11,21,7,1.922476863,1.614880565,128,25
E1863,Sales,53,76,13.70221097,1,8,8,10,4,1.088271692,0.680169807,129,16
E1864,Engineering,50,69,8.362977311,-1,8,4,17,7,1.281643606,1.815661775,119,12
E1865,Support,66,69,13.36776634,1,11,6,14,4,1.183204097,0.974403374,135,17
E1866,Sales,47,69,9.470271906,0,9,2,23,7,1.050593538,2.196695578,116,11
E1867,Marketing,51,67,11.73980299,1,8,3,18,6,0.863435644,1.41289469,118,11
E1868,Operations,53,73,13.87460024,1,5,4,19,7,0.605058277,1.277345252,126,9
E1869,Sales,60,76,16.213116,2,5,6,19,1,0.639047573,1.103809444,136,11
E1870,Support,47,75,13.21726197,1,12,2,27,11,0.984718438,1.899099845,122,14
E1871,Support,57,71,10.60844864,0,12,6,18,12,1.550594791,1.550594791,128,18
E1872,Engineering,45,76,11.68287192,1,10,3,18,8,1.025004438,1.419236914,121,13
E1873,Finance,54,74,13.74702182,1,12,6,19,1,1.220585432,1.288395734,128,18
E1874,Sales,45,67,12.12970422,1,9,3,25,4,0.913958136,1.904079451,112,12
E1875,Operations,50,91,8.802248842,0,12,4,18,9,1.632278496,1.836313308,141,16
E1876,Sales,41,72,11.84436535,1,6,3,17,10,0.700696357,1.323537562,113,9
E1877,HR,56,78,13.91092669,1,8,4,24,6,0.804778955,1.609557911,134,12
E1878,Finance,40,52,15.43728999,2,8,4,18,12,0.73004735,1.095071025,92,12
E1879,Operations,59,76,10.18640941,0,7,9,21,3,1.430307028,1.877277974,135,16
E1880,Operations,52,75,6.649722809,-1,7,3,14,1,1.307236909,1.830131673,127,10
E1881,Marketing,43,78,4.660973676,-2,6,5,20,6,1.943128626,3.532961138,121,11
E1882,Engineering,55,66,12.38691289,1,5,6,18,11,0.821698034,1.344596782,121,11
E1883,Marketing,44,83,5.399704258,-2,11,2,20,1,2.031343868,3.125144412,127,13
E1884,Operations,52,68,10.96012111,0,9,3,19,3,1.003334322,1.588612676,120,12
E1885,Finance,43,67,13.23303238,1,9,6,16,8,1.053886452,1.124145549,110,15
E1886,Sales,41,77,9.51046377,0,10,5,25,5,1.427149204,2.378582006,118,15
E1887,Sales,58,68,5.512169687,-2,8,5,19,4,1.996262479,2.917614392,126,13
E1888,Finance,48,90,6.220175922,-1,8,6,31,10,1.939010926,4.293524193,138,14
E1889,Operations,40,77,7.240550776,-1,11,3,23,3,1.698915568,2.791075576,117,14
E1890,Support,54,81,9.627830385,0,5,6,23,12,1.0350184,2.164129382,135,11
E1891,Sales,51,79,13.61244214,1,10,5,20,10,1.026522456,1.368696608,130,15
E1892,Support,54,78,10.03527031,0,14,5,17,10,1.721752115,1.54051505,132,19
E1893,Sales,55,74,16.45989355,2,5,7,23,10,0.687289414,1.31730471,129,12
E1894,Sales,44,74,13.12263775,1,15,4,20,6,1.345357739,1.416166042,118,19
E1895,Engineering,53,76,10.88644186,0,6,4,24,4,0.841294655,2.019107171,129,10
E1896,Engineering,43,73,9.785327811,0,8,4,18,7,1.112622649,1.668933974,116,12
E1897,HR,42,60,8.506998428,-1,4,6,19,8,1.051856701,1.998527731,102,10
E1898,Marketing,50,75,10.44787711,0,6,8,20,8,1.222934162,1.747048802,125,14
E1899,Finance,54,82,11.62707349,1,7,8,26,6,1.187923711,2.059067765,136,15
E1900,Finance,46,75,10.96363869,0,9,1,19,5,0.835866099,1.588145588,121,10
E1901,Finance,46,75,8.504173614,-1,6,4,27,7,1.052169332,2.840857196,121,10
E1902,HR,42,75,6.904233054,-1,5,2,26,9,0.885601418,3.289376695,117,7
E1903,Engineering,44,67,15.58769724,2,7,5,17,10,0.72342772,1.024855937,111,12
E1904,Operations,54,57,11.90274388,1,6,4,17,8,0.775028947,1.31754921,111,10
E1905,Support,56,64,11.06650806,0,9,12,24,5,1.740354368,1.98897642,120,21
E1906,Support,52,79,11.51916304,0,14,3,23,12,1.357918253,1.837183519,131,17
E1907,Operations,45,68,13.30408708,1,11,7,21,3,1.258381601,1.468111868,113,18
E1908,HR,55,68,8.596400393,0,7,4,19,11,1.146263135,1.979909052,123,11
E1909,Operations,43,64,9.611048395,0,6,7,20,7,1.225138131,1.884827894,107,13
E1910,Finance,51,60,7.742496628,-1,10,5,20,7,1.715757024,2.287676032,111,15
E1911,Marketing,57,72,9.978432045,0,7,6,13,8,1.184139952,1.184139952,129,13
E1912,Sales,46,68,7.972171594,-1,3,6,16,12,1.003101636,1.783291797,114,9
E1913,Support,41,83,6.980879127,-1,6,4,18,10,1.252994794,2.25539063,124,10
E1914,Engineering,50,67,5.140945545,-2,13,0,18,11,2.11693784,2.931144702,117,13
E1915,Engineering,50,70,14.9741099,2,8,6,19,6,0.876418159,1.189424645,120,14
E1916,HR,46,56,8.996370102,0,11,5,9,11,1.600580995,0.900326809,102,16
E1917,Engineering,38,80,11.46026587,0,11,2,23,7,1.043316422,1.845867516,118,13
E1918,Finance,47,75,10.28907529,0,7,5,10,12,1.062974574,0.885812145,122,12
E1919,Support,46,68,11.49167843,0,6,2,32,2,0.640426348,2.561705392,114,8
E1920,Operations,59,73,3.989472218,-2,5,4,20,10,1.803797998,4.008439996,132,9
E1921,Finance,43,86,8.590341069,0,12,2,28,2,1.459802097,2.919604193,129,14
E1922,HR,52,77,13.47862373,1,5,12,16,12,1.174144747,1.105077409,129,17
E1923,Finance,43,61,15.82920347,2,5,2,22,6,0.415943631,1.307251412,104,7
E1924,Operations,41,80,8.906454876,0,7,6,22,1,1.312275699,2.22077426,121,13
E1925,Marketing,50,59,9.252224291,0,11,6,24,7,1.658176754,2.340955418,109,17
E1926,HR,54,56,13.19924654,1,8,4,21,6,0.845115265,1.478951714,110,12
E1927,Marketing,43,64,11.32218433,0,3,7,18,3,0.811544425,1.460779965,107,10
E1928,Sales,57,66,10.08891272,0,4,7,12,8,0.991981836,1.082162003,123,11
E1929,Marketing,50,54,9.80634552,0,8,8,18,1,1.480611551,1.665687995,104,16
E1930,Sales,61,74,8.288570597,-1,8,6,24,4,1.50722868,2.583820594,135,14
E1931,Sales,49,63,8.183646142,-1,16,4,19,8,2.177784258,2.068895045,112,20
E1932,Marketing,58,79,10.39612104,0,9,7,25,9,1.403986492,2.193728894,137,16
E1933,HR,42,59,10.94997944,0,6,6,15,2,1.004185828,1.255232286,101,12
E1934,Operations,43,72,11.10611691,0,6,6,20,6,0.991234438,1.652057397,115,12
E1935,Finance,49,66,7.943597278,-1,8,5,15,8,1.453553821,1.677177486,115,13
E1936,Finance,50,89,13.99779196,1,2,4,23,11,0.40005889,1.533559078,139,6
E1937,Operations,68,60,5.136157759,-2,4,1,21,3,0.814842153,3.422337043,128,5
E1938,Support,52,64,11.58884855,1,7,6,20,8,1.032659972,1.58870765,116,13
E1939,Support,61,72,8.380199948,-1,7,5,22,12,1.279290427,2.345365783,133,12
E1940,Sales,59,79,7.402326678,-1,7,10,20,8,2.023249113,2.380293074,138,17
E1941,Sales,58,77,9.02551702,0,6,6,21,12,1.196945751,2.094655065,135,12
E1942,HR,45,65,5.225170123,-2,6,3,21,3,1.445743622,3.373401784,110,9
E1943,Engineering,46,84,11.06282355,0,8,7,22,4,1.243489962,1.823785277,130,15
E1944,Marketing,52,54,14.84345291,2,6,5,24,3,0.694293098,1.514821304,106,11
E1945,Sales,59,72,8.067166274,-1,5,3,23,3,0.882304323,2.536624928,131,8
E1946,Finance,51,58,17.05259415,2,3,7,28,5,0.553937008,1.551023624,109,10
E1947,HR,39,64,7.417416233,-1,3,8,18,7,1.306814312,2.138423419,103,11
E1948,Marketing,55,63,8.730290992,0,2,9,21,2,1.130490343,2.158208836,118,11
E1949,HR,55,60,14.07943335,1,7,7,17,3,0.92841685,1.127363317,115,14
E1950,Marketing,63,63,6.408622969,-1,6,7,18,9,1.75471205,2.4296013,126,13
E1951,Marketing,54,67,9.32014148,0,8,7,22,3,1.453468446,2.131753721,121,15
E1952,Operations,45,76,15.15715558,2,9,2,18,6,0.680812903,1.114057478,121,11
E1953,Sales,52,78,6.463231859,-1,8,4,28,6,1.607882514,3.751725865,130,12
E1954,HR,48,79,11.77165639,1,16,6,20,5,1.722564351,1.565967592,127,22
E1955,HR,72,76,11.53175837,0,6,6,18,6,0.957567138,1.436350707,148,12
E1956,Operations,57,89,4.231790303,-2,4,11,21,11,2.867087389,4.013922344,146,15
E1957,Finance,54,65,8.153299212,-1,5,5,17,11,1.092502252,1.857253828,119,10
E1958,Finance,60,80,17.1444733,2,9,2,7,2,0.606245208,0.385792405,140,11
E1959,Support,43,82,10.67138611,0,10,6,17,7,1.37087402,1.456553646,125,16
E1960,Sales,50,79,11.15150445,0,5,6,17,4,0.905237705,1.399003725,129,11
E1961,Sales,56,74,10.71380795,0,12,5,17,5,1.451278703,1.451278703,130,17
E1962,Engineering,46,72,16.12840306,2,7,4,23,6,0.642208148,1.342798854,118,11
E1963,Operations,55,74,7.078670113,-1,8,3,22,12,1.361610246,2.723220492,129,11
E1964,Finance,46,69,7.964621344,-1,5,4,22,4,1.003946475,2.454091384,115,9
E1965,Marketing,63,61,9.667733803,0,4,4,14,9,0.749924974,1.312368705,124,8
E1966,HR,55,71,11.66720195,1,10,3,24,6,1.02627242,1.894656775,126,13
E1967,Sales,58,64,10.46112525,0,5,6,15,11,0.959766145,1.308772017,122,11
E1968,HR,45,60,10.54597098,0,12,7,27,4,1.645595683,2.338478076,105,19
E1969,HR,58,82,8.343440331,-1,5,3,13,7,0.856215668,1.39135046,140,8
E1970,Engineering,49,86,11.82133315,1,8,6,19,7,1.091930132,1.48190518,135,14
E1971,Finance,31,70,4.32316995,-2,12,4,14,12,3.005727818,2.630011841,101,16
E1972,Sales,45,59,8.35732828,-1,7,4,18,4,1.175549224,1.923626003,104,11
E1973,HR,56,77,7.536455052,-1,2,1,15,1,0.351433936,1.757169681,133,3
E1974,Sales,49,64,6.696291862,-1,6,2,24,5,1.039461619,3.118384857,113,8
E1975,Marketing,64,89,4.657998755,-2,9,3,18,4,2.120891241,3.181336861,153,12
E1976,Engineering,39,59,10.69754841,0,10,5,16,2,1.282319976,1.367807974,98,15
E1977,Marketing,50,67,11.28878248,0,12,3,20,9,1.220625398,1.62750053,117,15
E1978,Sales,51,61,11.31017405,0,9,7,24,10,1.299737919,1.949606879,112,16
E1979,Support,54,66,12.8239049,1,10,4,13,5,1.012738448,0.940399988,120,14
E1980,Sales,44,70,13.34644434,1,10,4,17,2,0.975851554,1.184962601,114,14
E1981,Finance,57,67,3.882119344,-2,7,3,21,3,2.048290772,4.301410621,124,10
E1982,HR,53,63,11.89279384,1,10,5,17,10,1.163440616,1.318566031,116,15
E1983,HR,45,82,10.54747829,0,7,8,22,2,1.298984906,1.905177862,127,15
E1984,Marketing,47,66,10.51407455,0,9,6,19,2,1.30275342,1.650154332,113,15
E1985,Engineering,45,74,9.628410196,0,8,5,26,1,1.223136834,2.446273668,119,13
E1986,Support,52,66,8.348819092,-1,9,0,23,3,0.962688433,2.460203773,118,9
E1987,Operations,46,81,11.58364562,1,12,8,14,2,1.589364529,1.112555171,127,20
E1988,HR,50,76,7.058840621,-1,8,4,20,10,1.489047937,2.481746561,126,12
E1989,Finance,55,75,13.30856704,1,11,5,15,6,1.118211205,1.048323005,130,16
E1990,Marketing,55,70,8.507012822,-1,12,6,26,10,1.893339195,2.734823281,125,18
E1991,Marketing,54,75,3.876116157,-2,6,3,17,6,1.845731256,3.486381262,129,9
E1992,Operations,47,64,10.33782518,0,11,5,19,4,1.411205389,1.6758064,111,16
E1993,Finance,58,67,6.467780258,-1,7,6,15,8,1.740811801,2.008629001,125,13
E1994,Engineering,49,69,6.405399007,-1,14,5,16,11,2.565695648,2.160585808,118,19
E1995,Finance,57,78,12.05139126,1,7,3,10,7,0.76620184,0.76620184,135,10
E1996,Engineering,44,65,12.80409826,1,5,3,17,2,0.579538036,1.231518327,109,8
E1997,Finance,46,59,9.672939125,0,13,3,23,11,1.499118454,2.154982778,105,16
E1998,Finance,56,60,3.961547251,-2,8,11,18,1,3.82945058,3.62790055,116,19
E1999,Sales,58,59,11.59425755,1,7,5,18,12,0.952815198,1.429222797,117,12
E2000,Marketing,52,78,9.041356088,0,7,8,27,5,1.493822136,2.688879845,130,15
E2001,Finance,60,71,14.13478662,1,12,8,31,5,1.321459001,2.048261451,131,20
E2002,Operations,49,72,15.90139654,2,5,5,26,6,0.591667084,1.538334417,121,10
E2003,Finance,53,66,5.487188026,-2,12,5,25,3,2.62054991,3.853749868,119,17
E2004,HR,43,60,17.41775174,2,4,4,21,2,0.434363548,1.140204315,103,8
E2005,Marketing,39,67,5.325237888,-2,8,4,19,4,1.897161848,3.003839592,106,12
E2006,HR,47,69,8.384907729,-1,9,4,22,11,1.385202751,2.34418927,116,13
E2007,Marketing,47,75,13.07888118,1,9,2,15,8,0.781312084,1.065425569,122,11
E2008,HR,48,58,7.835049718,-1,10,2,18,1,1.358226652,2.037339978,106,12
E2009,Finance,52,68,7.56000034,-1,8,3,18,11,1.285046678,2.102803655,120,11
E2010,Finance,50,62,4.880657331,-2,5,3,16,7,1.360392138,2.720784276,112,8
E2011,Sales,62,73,5.993038531,-1,2,7,15,2,1.286994196,2.144990326,135,9
E2012,Operations,41,68,7.556980237,-1,11,4,12,3,1.752954849,1.402363879,109,15
E2013,HR,33,62,12.32320282,1,8,2,17,2,0.750570275,1.275969467,95,10
E2014,Engineering,43,62,15.03554469,2,13,4,18,3,1.060144843,1.122506304,105,17
E2015,Sales,53,73,7.72424586,-1,10,4,18,11,1.60472323,2.063215582,126,14
E2016,HR,50,77,8.797682611,0,11,4,17,3,1.530974272,1.735104175,127,15
E2017,HR,56,91,7.018386792,-1,9,8,18,5,2.120127208,2.244840573,147,17
E2018,Sales,60,74,5.415330267,-2,3,3,17,5,0.935259722,2.649902545,134,6
E2019,Finance,57,57,5.423419416,-2,8,6,14,3,2.179524501,2.179524501,114,14
E2020,HR,43,60,6.173480798,-1,6,4,15,7,1.394023387,2.091035081,103,10
E2021,Finance,55,58,9.849740988,0,9,3,14,6,1.106017186,1.290353384,113,12
E2022,Sales,58,71,8.114696419,-1,6,5,30,12,1.206842169,3.291387735,129,11
E2023,Finance,58,58,8.868261282,0,6,5,19,9,1.114684714,1.925364505,116,11
E2024,Marketing,46,52,11.19042426,0,6,4,16,4,0.820315994,1.312505591,98,10
E2025,Engineering,58,63,9.722458908,0,5,5,14,1,0.9326219,1.30567066,121,10
E2026,Support,56,75,6.506275855,-1,10,5,21,11,1.998327838,2.797658973,131,15
E2027,HR,63,76,12.87183142,1,8,9,29,10,1.225505089,2.090567504,139,17
E2028,Operations,45,74,3.935991341,-2,11,7,23,7,3.646683869,4.65965161,119,18
E2029,Engineering,63,68,7.678191918,-1,8,7,15,6,1.728470647,1.728470647,131,15
E2030,Support,52,67,15.16651612,2,10,7,17,5,1.051556184,1.051556184,119,17
E2031,Finance,55,82,11.02150223,0,7,8,19,4,1.24776419,1.580501308,137,15
E2032,HR,45,69,4.605308849,-2,10,2,16,5,2.14082762,2.854436826,114,12
E2033,Finance,52,59,5.250052085,-2,9,6,20,6,2.399979999,3.199973332,111,15
E2034,Marketing,51,80,8.980213115,0,9,5,20,5,1.402775656,2.003965223,131,14
E2035,Sales,52,76,8.540146115,0,10,5,30,1,1.572302963,3.144605925,128,15
E2036,HR,49,75,12.12721359,1,5,3,26,10,0.609421028,1.98061834,124,8
E2037,Support,61,64,13.39224693,1,4,4,17,3,0.555854832,1.181191518,125,8
E2038,Support,55,57,8.453154065,-1,12,3,12,4,1.586771981,1.269417585,112,15
E2039,Marketing,54,80,9.683966362,0,2,6,25,2,0.748785585,2.339954952,134,8
E2040,Marketing,47,56,6.902300333,-1,11,6,14,7,2.151272324,1.771636031,103,17
E2041,HR,50,82,9.526499836,0,6,6,18,1,1.139980068,1.709970102,132,12
E2042,Finance,39,62,6.924900778,-1,9,4,19,9,1.640399087,2.397506358,101,13
E2043,Operations,49,65,10.07313729,0,12,5,15,7,1.535246927,1.354629641,114,17
E2044,Support,52,76,8.120563335,-1,6,5,19,10,1.206065853,2.083204655,128,11
E2045,Support,41,82,11.87691208,1,11,7,26,8,1.397850657,2.019117615,123,18
E2046,Marketing,41,71,13.14822241,1,7,3,19,12,0.706802573,1.342924888,112,10
E2047,Engineering,35,79,13.88181761,1,6,2,23,4,0.537568744,1.545510139,114,8
E2048,Marketing,42,60,10.10826306,0,9,3,24,6,1.080276902,2.160553804,102,12
E2049,Operations,51,69,11.82139001,1,11,2,34,9,1.013930626,2.65181856,120,13
E2050,Finance,35,87,8.501179467,-1,4,3,20,5,0.736750634,2.105001813,122,7
E2051,Finance,54,70,7.477474022,-1,8,7,30,11,1.769394983,3.538789965,124,15
E2052,Engineering,57,69,5.897651642,-1,9,4,13,11,1.884699413,1.884699413,126,13
E2053,Support,68,57,11.07574349,0,7,3,23,5,0.828106361,1.90464463,125,10
E2054,Marketing,47,72,3.8483662,-2,9,5,27,6,2.887570662,5.568886277,119,14
E2055,Finance,51,65,12.61885964,1,13,7,20,12,1.468551739,1.468551739,116,20
E2056,Operations,55,69,8.923591463,0,6,3,26,8,0.906929717,2.620019183,124,9
E2057,HR,42,68,9.121959149,0,5,3,13,4,0.790360827,1.284336343,110,8
E2058,Sales,41,60,12.02198067,1,11,7,25,4,1.3822782,1.919830833,101,18
E2059,Sales,49,78,4.498627775,-2,10,7,18,5,3.091680451,3.273544007,127,17
E2060,Sales,41,70,9.333988423,0,12,4,20,8,1.548288942,1.935361177,111,16
E2061,Support,50,69,14.73529462,2,5,7,13,8,0.762616798,0.826168198,119,12
E2062,Marketing,52,85,9.148358397,0,10,5,16,4,1.478071567,1.576609672,137,15
E2063,Engineering,51,76,6.03061266,-1,11,4,25,4,2.133526725,3.555877874,127,15
E2064,Finance,58,68,8.960349335,0,8,8,12,8,1.606369361,1.204777021,126,16
E2065,HR,47,66,13.92672942,1,7,6,18,10,0.870920858,1.205890419,113,13
E2066,Operations,59,65,7.704667676,-1,3,7,29,5,1.148808935,3.331545911,124,10
E2067,HR,62,67,5.380260228,-2,5,2,14,2,1.097133933,2.194267867,129,7
E2068,Operations,55,83,8.599336277,0,9,7,18,6,1.666781904,1.875129642,138,16
E2069,Support,55,78,5.785771462,-1,13,4,19,3,2.505242049,2.799976408,133,17
E2070,Marketing,63,75,3.231212188,-2,12,2,14,5,3.308744487,3.308744487,138,14
E2071,Sales,45,73,12.2610149,1,11,2,19,8,0.980317125,1.432771183,118,13
E2072,Marketing,45,64,13.14414516,1,2,6,16,11,0.565605055,1.13121011,109,8
E2073,Support,48,75,11.25702897,0,8,3,23,2,0.897444236,1.876474312,123,11
E2074,Engineering,50,79,12.68044848,1,6,5,18,1,0.804067207,1.315746339,129,11
E2075,Engineering,48,67,8.780908889,0,7,6,30,1,1.329119834,3.067199617,115,13
E2076,Support,67,70,14.05526337,1,10,7,18,1,1.129173206,1.195595159,137,17
E2077,Operations,63,72,8.114934195,-1,8,3,20,11,1.206810687,2.19420125,135,11
E2078,Finance,54,72,10.00154703,0,11,3,20,11,1.272548303,1.817926146,126,14
E2079,Finance,45,65,7.468995248,-1,5,7,21,6,1.416933137,2.479632989,110,12
E2080,Operations,49,74,5.7936574,-1,9,6,21,7,2.207941778,3.091118489,123,15
E2081,Engineering,46,65,8.092436375,-1,2,7,18,6,0.989833707,1.979667413,111,9
E2082,Engineering,50,65,16.68765103,2,5,4,25,4,0.508829578,1.413415493,115,9
E2083,Engineering,44,58,14.60007013,2,11,6,22,2,1.089738691,1.41025007,102,17
E2084,Marketing,52,79,12.32536337,1,8,5,21,8,0.975583152,1.575942015,131,13
E2085,Engineering,49,70,8.714343576,0,10,3,27,9,1.338227323,2.77939521,119,13
E2086,HR,52,79,8.646259861,0,7,4,20,3,1.140338344,2.073342444,131,11
E2087,Sales,53,88,15.1398969,2,10,7,21,5,1.053290495,1.301123553,141,17
E2088,Engineering,51,74,10.06694013,0,7,4,28,8,0.993951342,2.530057962,125,11
E2089,Operations,51,59,12.37195345,1,5,5,20,7,0.747833893,1.495667785,110,10
E2090,Sales,63,65,8.338839379,-1,8,5,22,5,1.392035934,2.35575312,128,13
E2091,Marketing,49,71,9.10805168,0,7,12,22,2,1.879689638,2.176482738,120,19
E2092,Operations,48,61,12.34200843,1,8,5,24,6,0.974366046,1.798829624,109,13
E2093,Sales,57,79,7.793790349,-1,11,6,19,11,1.933182317,2.160615531,136,17
E2094,Operations,51,73,11.04480953,0,10,5,16,1,1.245349706,1.328373019,124,15
E2095,Marketing,58,67,7.899028283,-1,10,5,17,12,1.685577293,1.910320932,125,15
E2096,HR,48,68,11.53054647,0,6,4,15,7,0.798049791,1.197074687,116,10
E2097,Marketing,55,70,7.809010741,-1,8,7,21,9,1.702801874,2.383922624,125,15
E2098,Marketing,54,69,15.25769566,2,1,3,25,5,0.246037328,1.5377333,123,4
E2099,Operations,44,66,9.807273465,0,6,1,11,8,0.647711934,1.01783304,110,7
E2100,Support,40,81,12.32347367,1,9,5,22,11,1.050777023,1.651221036,121,14
E2101,Finance,44,93,9.938017287,0,10,6,19,1,1.462787961,1.737060703,137,16
E2102,Engineering,50,63,8.495888965,-1,10,6,21,4,1.684939668,2.211483314,113,16
E2103,Engineering,51,78,11.72291209,1,7,4,24,2,0.864581939,1.886360593,129,11
E2104,HR,53,61,13.46140446,1,12,4,27,11,1.106393231,1.867038577,114,16
E2105,HR,48,72,5.654939223,-1,8,2,23,9,1.502643325,3.456079647,120,10
E2106,Engineering,48,68,10.39310621,0,8,6,22,3,1.228813261,1.930992268,116,14
E2107,Finance,43,72,9.675729484,0,9,4,20,10,1.217715381,1.873408279,115,13
E2108,Engineering,52,60,10.62931315,0,4,10,22,3,1.203854417,1.891771226,112,14
E2109,Support,55,56,14.06154351,1,7,10,15,12,1.12870238,0.995913864,111,17
E2110,Finance,52,80,12.4488331,1,5,6,20,1,0.817914827,1.487117867,132,11
E2111,HR,44,58,13.46994801,1,8,6,19,6,0.967522481,1.313066225,102,14
E2112,Sales,48,80,10.78930876,0,7,6,19,6,1.102693997,1.611629688,128,13
E2113,Operations,39,66,8.699139672,0,7,3,19,10,1.03101928,1.958936632,105,10
E2114,Support,51,72,2.7256167,-2,10,6,14,10,4.294591014,3.757767137,123,16
E2115,Support,55,70,14.24596799,1,9,5,19,3,0.918275573,1.246231135,125,14
E2116,HR,65,67,2.499601132,-3,7,5,18,8,3.428962201,5.143443302,132,12
E2117,HR,51,68,14.76270858,2,12,6,23,5,1.141935722,1.459140089,119,18
E2118,Marketing,45,74,12.22278308,1,9,7,18,7,1.210032707,1.361286795,119,16
E2119,Support,54,66,15.90565971,2,7,7,17,10,0.828125033,1.005580397,120,14
E2120,Marketing,48,64,10.7971346,0,8,3,18,9,0.932429812,1.525794238,112,11
E2121,Marketing,48,84,11.50090026,0,5,6,25,4,0.879936626,1.999855969,132,11
E2122,Operations,56,68,9.444217904,0,3,5,16,1,0.765974061,1.531948122,124,8
E2123,Marketing,49,61,10.22737435,0,10,5,21,2,1.336020296,1.870428415,110,15
E2124,Finance,46,63,7.825798173,-1,6,5,20,4,1.246346198,2.266083997,109,11
E2125,Engineering,57,73,9.647738099,0,10,3,15,11,1.220916581,1.408749902,130,13
E2126,Sales,57,72,7.460473875,-1,8,5,21,3,1.536556958,2.48213047,129,13
E2127,HR,55,75,10.13867186,0,8,5,23,4,1.167105034,2.064878136,130,13
E2128,Finance,54,71,9.923057356,0,9,5,25,3,1.281692437,2.288736494,125,14
E2129,Sales,56,83,9.939473766,0,13,2,16,8,1.37118113,1.462593205,139,15
E2130,Support,49,77,9.729111242,0,7,1,19,9,0.74563492,1.770882934,126,8
E2131,Support,40,60,8.145806035,-1,6,7,28,12,1.421416543,3.061512555,100,13
E2132,Support,73,72,11.67864266,1,5,5,22,12,0.788727963,1.735201518,145,10
E2133,Finance,46,76,10.94473117,0,8,8,17,10,1.339502729,1.423221649,122,16
E2134,Finance,53,73,10.8288163,0,8,5,19,9,1.099011065,1.606246942,126,13
E2135,HR,53,62,7.174654665,-1,9,4,21,2,1.590281245,2.568915858,115,13
E2136,Engineering,39,76,12.02000018,1,11,5,16,6,1.228878631,1.228878631,115,16
E2137,Marketing,40,63,7.708622805,-1,8,3,23,6,1.263115908,2.641060535,103,11
E2138,Support,34,66,8.431702526,-1,2,3,22,8,0.530126983,2.332558723,100,5
E2139,Operations,53,71,10.27523661,0,8,6,19,4,1.241659088,1.685108762,124,14
E2140,Engineering,57,75,13.45046657,1,6,3,21,1,0.62281726,1.453240274,132,9
E2141,Operations,47,63,6.376527122,-1,14,2,16,12,2.169042388,2.169042388,110,16
E2142,HR,38,59,7.034023044,-1,8,9,23,3,2.116000901,2.862824749,97,17
E2143,HR,56,63,4.111314963,-2,12,3,21,2,2.934665563,4.108531788,119,15
E2144,HR,56,73,11.51863452,0,6,3,14,7,0.718928249,1.118332833,129,9
E2145,Sales,61,69,8.988172989,0,4,7,16,5,1.101302512,1.601894562,130,11
E2146,Operations,52,74,11.27323694,0,10,2,17,9,0.977737174,1.385127663,126,12
E2147,Engineering,44,61,11.01472354,0,9,8,23,4,1.414930602,1.914317873,105,17
E2148,Engineering,45,63,12.36409791,1,7,5,18,3,0.897928171,1.346892257,108,12
E2149,Finance,47,76,10.00431752,0,8,6,16,9,1.272227921,1.453974767,123,14
E2150,Finance,57,87,7.872093655,-1,9,5,24,7,1.577981539,2.70511121,144,14
E2151,Support,56,51,10.6960405,0,5,5,13,1,0.854990199,1.111487259,107,10
E2152,Finance,46,67,11.24366831,0,10,2,20,1,0.980098423,1.633497371,113,12
E2153,HR,46,78,8.954943576,0,7,1,27,3,0.803620828,2.712220295,124,8
E2154,Engineering,46,69,10.27250113,0,14,8,26,3,1.951652056,2.306497884,115,22
E2155,Operations,41,63,5.964973733,-1,5,3,22,1,1.148604475,3.158662307,104,8
E2156,HR,62,72,6.182523594,-1,8,8,21,1,2.227629299,2.923763455,134,16
E2157,Sales,51,88,5.018678746,-2,6,6,17,2,1.993793074,2.824540188,139,12
E2158,Finance,53,77,10.86567445,0,15,2,20,2,1.432704064,1.685534193,130,17
E2159,HR,45,52,12.21989458,1,12,5,24,3,1.285940663,1.815445641,97,17
E2160,HR,55,62,5.723263737,-1,11,6,20,11,2.528533859,2.974745716,117,17
E2161,Sales,39,66,10.48334068,0,9,6,15,10,1.306240093,1.306240093,105,15
E2162,Marketing,39,72,11.34148322,0,7,4,12,3,0.891302918,0.972330456,111,11
E2163,Engineering,58,58,8.802085334,0,13,7,15,9,2.040382155,1.530286616,116,20
E2164,Operations,50,68,14.80464678,2,6,6,15,1,0.759270369,0.949087962,118,12
E2165,Support,46,84,5.628585411,-1,10,4,23,5,2.11206451,3.469820267,130,14
E2166,Marketing,45,75,8.867322717,0,8,1,23,10,0.912101515,2.330926094,120,9
E2167,Finance,43,56,1.263285111,-3,2,6,26,2,3.534685029,11.48772635,99,8
E2168,HR,46,68,11.03688152,0,13,3,21,5,1.329247943,1.744637925,114,16
E2169,Sales,49,80,7.804224235,-1,13,4,30,5,1.930891302,3.40745524,129,17
E2170,Sales,43,61,4.072865746,-2,2,3,15,3,0.985636177,2.956908531,104,5
E2171,Engineering,56,70,11.78202973,1,10,6,25,12,1.251757376,1.9558709,126,16
E2172,Marketing,36,75,9.529412125,0,8,1,20,2,0.854748574,1.899441276,111,9
E2173,Support,47,60,9.07906975,0,6,5,17,8,1.09137056,1.686663593,107,11
E2174,Engineering,59,85,13.38231515,1,8,5,19,2,0.903887856,1.321066866,144,13
E2175,HR,56,79,7.656311868,-1,3,4,9,2,0.80865848,1.03970376,135,7
E2176,Engineering,57,64,11.93185779,1,13,5,12,2,1.391911378,0.927940919,121,18
E2177,Operations,35,61,12.36790022,1,6,4,14,10,0.74806064,1.047284897,96,10
E2178,Sales,64,70,8.312495602,-1,6,3,19,6,0.966443409,2.04026942,134,9
E2179,Sales,39,73,10.02540445,0,7,6,18,3,1.179095067,1.63259317,112,13
E2180,Finance,57,60,15.03622965,2,4,5,15,5,0.561229179,0.935381965,117,9
E2181,Finance,49,67,6.970625963,-1,11,6,28,3,2.132831233,3.512898501,116,17
E2182,Support,49,62,11.6647923,1,6,4,23,7,0.789590525,1.816058207,111,10
E2183,HR,54,57,10.1863334,0,5,6,21,12,0.983342764,1.877290731,111,11
E2184,Operations,53,56,13.81205416,1,9,3,21,3,0.810150967,1.417764192,109,12
E2185,Marketing,47,57,9.898797157,0,9,5,16,1,1.284545423,1.468051912,104,14
E2186,Engineering,53,68,12.05725918,1,10,4,22,8,1.072200514,1.684886522,121,14
E2187,Support,59,61,5.198443716,-2,13,2,20,3,2.419962282,3.226616376,120,15
E2188,HR,49,67,3.567502086,-2,8,4,28,1,2.6272566,6.130265399,116,12
E2189,Finance,64,84,6.852283236,-1,11,5,23,12,2.037623901,2.929084358,148,16
E2190,Engineering,57,72,8.675362831,0,8,4,25,3,1.240263565,2.583882428,129,12
E2191,Finance,44,68,8.93747831,0,8,6,18,5,1.408808106,1.811324708,112,14
E2192,Engineering,55,84,13.27683724,1,14,8,12,5,1.54095754,0.840522295,139,22
E2193,Marketing,46,82,8.821034578,0,3,4,21,9,0.712755865,2.138267596,128,7
E2194,HR,51,64,10.07147864,0,7,3,17,3,0.903221722,1.535476927,115,10
E2195,Engineering,51,83,10.41868287,0,7,1,13,12,0.700606198,1.138485072,134,8
E2196,Operations,66,58,8.105494397,-1,6,7,16,10,1.427709406,1.757180808,124,13
E2197,Support,56,72,9.945082799,0,7,2,15,11,0.822287064,1.37047844,128,9
E2198,Sales,60,62,13.15348313,1,6,9,17,11,1.059809791,1.201117764,122,15
E2199,Operations,51,67,10.89757365,0,6,7,15,7,1.092659763,1.260761265,118,13
E2200,Operations,58,63,11.77962207,1,11,7,23,10,1.408492356,1.799740233,121,18
E2201,Support,44,59,10.9996609,0,8,3,15,4,0.916692571,1.250035324,103,11
E2202,Sales,44,75,14.9413725,2,6,6,21,3,0.752758271,1.317326974,119,12
E2203,Operations,41,72,6.842799596,-1,12,4,18,2,2.040087829,2.295098807,113,16
E2204,Engineering,62,72,17.50185216,2,11,2,22,10,0.702632357,1.189070143,134,13
E2205,Engineering,55,61,12.98902561,1,5,6,16,2,0.786330678,1.143753714,116,11
E2206,Engineering,44,56,13.53441774,1,3,3,10,7,0.412813235,0.688022058,100,6
E2207,Sales,56,71,13.92986339,1,7,5,20,12,0.803758192,1.339596986,127,12
E2208,Operations,69,67,13.10903096,1,6,3,14,3,0.637889308,0.992272257,136,9
E2209,Sales,43,80,6.129671038,-1,5,10,9,12,2.103883885,1.262330331,123,15
E2210,Engineering,54,61,6.600979982,-1,7,7,10,12,1.841867763,1.315619831,115,14
E2211,Support,56,85,12.09762894,1,9,10,29,11,1.450644241,2.21414121,141,19
E2212,Operations,50,54,11.73273902,1,12,5,18,8,1.335140851,1.413678548,104,17
E2213,Operations,55,60,12.65740593,1,7,4,16,7,0.805423816,1.171525551,115,11
E2214,Finance,58,76,10.13993615,0,11,4,21,5,1.34650682,1.885109548,134,15
E2215,Finance,40,77,6.048139109,-1,5,8,19,11,1.844458487,2.69574702,117,13
E2216,Marketing,58,68,9.669616962,0,12,6,27,7,1.687033383,2.530550075,126,18
E2217,HR,50,75,12.22409138,1,10,4,15,1,1.05867387,1.134293432,125,14
E2218,Finance,51,62,9.240485955,0,15,5,25,11,1.953032316,2.441290395,113,20
E2219,Sales,57,53,9.985730099,0,6,2,13,8,0.728217417,1.183353303,110,8
E2220,Finance,46,70,10.09015936,0,8,10,20,11,1.623060536,1.803400596,116,18
E2221,Marketing,54,79,8.433977956,-1,8,8,25,10,1.695997179,2.649995592,133,16
E2222,Operations,59,58,7.558272588,-1,7,4,12,3,1.285306104,1.402152114,117,11
E2223,Marketing,48,77,16.32512642,2,12,7,18,7,1.096673094,1.038953458,125,19
E2224,Operations,51,73,14.67580013,2,7,6,22,12,0.829303761,1.403437133,124,13
E2225,Support,40,63,13.21042701,1,6,8,18,4,0.98519207,1.266675518,103,14
E2226,Support,56,67,11.24509328,0,8,11,20,2,1.551641916,1.63330728,123,19
E2227,Operations,44,62,6.985898182,-1,9,9,29,10,2.25397314,3.63140117,106,18
E2228,HR,39,82,12.66190651,1,12,4,20,11,1.17113962,1.463924525,121,16
E2229,Finance,50,61,13.34592873,1,8,3,18,4,0.766768064,1.254711378,111,11
E2230,Sales,40,88,8.96657459,0,9,2,22,7,1.103689126,2.207378252,128,11
E2231,Sales,51,66,6.796898017,-1,5,3,22,11,1.026049075,2.821634957,117,8
E2232,Engineering,50,70,11.28075963,0,7,4,20,2,0.895710065,1.628563754,120,11
E2233,Operations,64,60,13.20374409,1,8,5,22,5,0.915251635,1.548887382,124,13
E2234,Sales,52,74,8.079881571,-1,4,6,22,6,1.10133595,2.422939091,126,10
E2235,HR,43,65,11.5861289,1,9,4,15,5,1.032883113,1.191788207,108,13
E2236,Operations,53,59,7.27768013,-1,9,6,10,12,1.812101913,1.208067942,112,15
E2237,HR,41,75,6.589961821,-1,7,7,21,7,1.844541558,2.766812336,116,14
E2238,Sales,59,73,10.61460026,0,8,3,17,6,0.947083822,1.463674997,132,11
E2239,Sales,50,53,7.556836835,-1,6,9,16,11,1.752984226,1.869849842,103,15
E2240,Engineering,46,70,11.2902578,0,5,2,25,5,0.569556808,2.034131457,116,7
E2241,Sales,54,65,5.153699334,-2,15,7,17,9,3.575085295,2.76256591,119,22
E2242,Operations,44,82,7.428899256,-1,3,5,19,11,0.949115627,2.254149614,126,8
E2243,Support,56,74,13.08731598,1,8,4,16,3,0.851830116,1.135773487,130,12
E2244,Operations,54,78,12.07754593,1,12,2,27,1,1.070537246,2.064607546,132,14
E2245,Operations,54,82,11.2571219,0,11,7,18,12,1.46853398,1.46853398,136,18
E2246,Engineering,63,62,8.663554998,0,6,8,16,12,1.448742208,1.65570538,125,14
E2247,Engineering,48,55,10.0411293,0,7,4,24,3,0.996274901,2.173690693,103,11
E2248,Sales,49,66,9.325717852,0,6,7,21,8,1.258992371,2.033756907,115,13
E2249,Marketing,49,72,17.00132392,2,16,2,21,12,0.999926454,1.166580863,121,18
E2250,Marketing,55,71,10.94930624,0,5,3,22,11,0.669494935,1.841111071,126,8
E2251,Engineering,39,82,7.700172633,-1,3,5,14,11,0.919521984,1.609163472,121,8
E2252,Sales,63,65,9.757258537,0,6,4,28,10,0.929604877,2.602893656,128,10
E2253,Marketing,42,62,4.958394924,-2,2,8,21,5,1.67830433,3.524439093,104,10
E2254,Sales,47,64,4.288665464,-2,10,4,17,6,2.647170651,3.214421505,111,14
E2255,Sales,56,66,14.38814201,1,6,6,17,8,0.779821241,1.104746758,122,12
E2256,Sales,50,62,10.82106556,0,7,3,11,6,0.845947427,0.93054217,112,10
E2257,Finance,40,65,8.645235359,0,6,4,26,5,1.036781336,2.695631473,105,10
E2258,Operations,39,71,9.920436561,0,8,7,22,1,1.373571461,2.014571476,110,15
E2259,Sales,53,88,9.687496875,0,9,4,29,11,1.216374625,2.713451086,141,13
E2260,Finance,49,73,10.20277032,0,8,3,20,5,0.981899984,1.785272698,122,11
E2261,Engineering,47,74,13.44324309,1,5,3,20,12,0.553892221,1.384730554,121,8
E2262,Marketing,55,73,11.60631178,1,7,3,22,12,0.793253425,1.745157535,128,10
E2263,Operations,39,72,8.771247448,0,6,3,25,8,0.921069705,2.558526957,111,9
E2264,Support,41,82,4.753359289,-2,6,3,24,5,1.564303487,4.171475966,123,9
E2265,Marketing,43,72,6.993066197,-1,11,6,23,6,2.126843389,2.877493997,115,17
E2266,Operations,49,58,12.27536843,1,6,4,13,6,0.753274763,0.979257191,107,10
E2267,Support,52,68,14.68629287,2,8,3,15,3,0.701249179,0.95624888,120,11
E2268,Marketing,50,70,7.366161169,-1,3,2,13,12,0.59764567,1.553878743,120,5
E2269,Operations,50,83,6.91266392,-1,6,2,19,7,1.011037507,2.401214078,133,8
E2270,Marketing,60,82,8.702851666,0,5,5,17,9,1.030624846,1.752062237,142,10
E2271,Marketing,42,71,15.35321858,2,10,6,25,2,0.978400669,1.528751045,113,16
E2272,Support,41,62,10.44310604,0,8,3,20,3,0.961277468,1.747777214,103,11
E2273,Marketing,42,70,7.713213455,-1,10,4,19,6,1.606755082,2.180596183,112,14
E2274,Marketing,57,80,8.916603999,0,17,3,20,5,2.016819468,2.016819468,137,20
E2275,Support,41,80,8.415443612,-1,4,7,19,5,1.168293333,2.017961212,121,11
E2276,Engineering,49,73,12.11239988,1,3,2,31,12,0.38131845,2.364174392,122,5
E2277,Sales,56,73,15.86044521,2,11,9,15,2,1.186208297,0.889656223,129,20
E2278,HR,50,67,10.39249556,0,11,7,20,7,1.579987449,1.75554161,117,18
E2279,Finance,54,81,13.28126519,1,8,6,21,4,0.980305303,1.470457955,135,14
E2280,HR,50,75,5.961795214,-1,13,6,16,9,2.729181112,2.298257778,125,19
E2281,HR,40,64,17.02301673,2,13,4,26,1,0.943238319,1.442599782,104,17
E2282,Operations,56,67,5.98276196,-1,11,4,20,12,2.148147121,2.864196161,123,15
E2283,Sales,53,71,13.6355405,1,10,12,22,5,1.503190128,1.503190128,124,22
E2284,Operations,47,69,11.01586425,0,7,4,14,7,0.915456414,1.165126346,116,11
E2285,Sales,42,73,6.225686269,-1,6,5,18,5,1.522346749,2.491112862,115,11
E2286,Support,39,68,12.50335661,1,8,3,25,1,0.814612271,1.851391526,107,11
E2287,Support,47,53,9.912757956,0,12,5,21,3,1.557809682,1.924353136,100,17
E2288,Sales,55,72,7.264830892,-1,4,4,20,9,0.967956889,2.419892223,127,8
E2289,Marketing,54,63,10.03220167,0,15,5,20,1,1.812874764,1.812874764,117,20
E2290,Engineering,51,71,5.050429573,-2,7,4,14,7,1.818052729,2.313885292,122,11
E2291,Marketing,40,68,8.552926016,0,5,8,20,9,1.360839598,2.093599382,108,13
E2292,Engineering,48,67,7.106700197,-1,8,9,15,4,2.0970308,1.850321294,115,17
E2293,Operations,51,65,9.452830707,0,7,6,18,3,1.243682249,1.722021575,116,13
E2294,Engineering,45,60,4.807657613,-2,10,5,21,4,2.582796887,3.615915641,105,15
E2295,Operations,46,76,4.627073386,-2,7,3,19,4,1.777122727,3.376533181,122,10
E2296,Support,52,63,7.452718597,-1,9,9,21,12,2.129492399,2.484407798,115,18
E2297,HR,40,80,9.885075821,0,7,2,25,9,0.826820148,2.296722633,120,9
E2298,Support,59,83,7.080238796,-1,12,7,17,3,2.351415655,2.103898217,142,19
E2299,Support,49,71,11.38463815,0,12,4,24,10,1.291923091,1.937884637,120,16
E2300,HR,58,73,12.10626511,1,11,7,23,11,1.373388975,1.754885912,131,18
E2301,Engineering,47,76,7.467589928,-1,10,7,17,11,2.007655088,2.007655088,123,17
E2302,Engineering,49,81,14.17140843,1,10,1,31,12,0.725048044,2.043317214,130,11
E2303,Operations,47,72,9.091298681,0,10,4,13,8,1.387333825,1.288238552,119,14
E2304,Marketing,53,65,15.49459917,2,5,3,18,11,0.485007239,1.091266288,118,8
E2305,Operations,59,68,9.221127868,0,9,6,13,7,1.467548415,1.271875293,127,15
E2306,Marketing,36,64,6.635091224,-1,7,3,16,11,1.309742046,2.095587273,100,10
E2307,Support,54,72,13.68427408,1,6,3,11,12,0.612900573,0.7491007,126,9
E2308,HR,51,59,6.875791973,-1,10,7,23,10,2.158513081,2.920341228,110,17
E2309,Support,45,84,13.4131128,1,3,7,22,11,0.693812651,1.526387832,129,10
E2310,Sales,50,83,10.36187675,0,6,7,17,12,1.144177171,1.496231685,133,13
E2311,Engineering,47,74,8.332340985,-1,7,4,17,1,1.178696751,1.821622252,121,11
E2312,Marketing,52,79,7.694714819,-1,11,4,16,5,1.725185968,1.840198366,131,15
E2313,Operations,58,67,9.741264046,0,5,7,15,5,1.117186948,1.396483685,125,12
E2314,HR,54,79,12.03954524,1,8,9,18,1,1.303726448,1.380416239,133,17
E2315,Marketing,45,67,9.879730225,0,9,2,24,10,1.011054481,2.20593705,112,11
E2316,Operations,42,73,14.43852557,1,11,4,22,1,0.971595372,1.425006546,115,15
E2317,Engineering,52,67,6.472687883,-1,7,4,20,7,1.472027224,2.676413134,119,11
E2318,Support,45,61,9.710160178,0,12,5,15,3,1.587277848,1.400539278,106,17
E2319,Engineering,47,68,13.3019804,1,6,8,19,1,0.978885414,1.328487347,115,14
E2320,Finance,58,65,6.388302811,-1,13,1,15,1,1.894887142,2.030236224,123,14
E2321,Sales,47,59,13.1207916,1,5,4,20,1,0.637358036,1.416351191,106,9
E2322,Finance,58,84,10.05938802,0,4,3,25,3,0.632946415,2.260522911,142,7
E2323,HR,36,63,10.33035533,0,5,3,17,2,0.706067883,1.500394251,99,8
E2324,Marketing,50,80,8.981340591,0,6,4,15,2,1.001869429,1.502804144,130,10
E2325,HR,60,64,6.373110274,-1,12,2,19,8,1.89879162,2.576931484,124,14
E2326,Support,42,70,9.763572322,0,3,9,13,2,1.114871498,1.207777456,112,12
E2327,Operations,47,73,8.332648587,-1,4,7,29,8,1.178657902,3.107370831,120,11
E2328,Engineering,53,72,14.57291725,2,8,5,15,8,0.834782577,0.963210666,125,13
E2329,Finance,48,73,11.53126784,0,4,6,23,9,0.798003851,1.835408858,121,10
E2330,Finance,45,72,10.1034964,0,6,7,23,12,1.170802379,2.071419594,117,13
E2331,Support,33,71,13.95321744,1,8,9,28,11,1.136879074,1.872506711,104,17
E2332,Finance,50,63,9.831663415,0,7,3,23,11,0.923219234,2.123404238,113,10
E2333,Support,43,74,12.10864185,1,11,3,22,7,1.06799775,1.678282179,117,14
E2334,HR,55,68,13.4926354,1,7,2,16,5,0.621005066,1.104009006,123,9
E2335,Engineering,37,80,9.183200284,0,8,3,22,3,1.080210513,2.160421025,117,11
E2336,Marketing,35,74,11.30482365,0,7,5,21,10,0.975227304,1.706647783,109,12
E2337,Operations,45,69,8.68992699,0,9,3,21,10,1.238399424,2.167198991,114,12
E2338,Marketing,46,68,13.43854919,1,11,7,22,10,1.24666265,1.523698795,114,18
E2339,HR,45,77,9.918269433,0,11,6,21,12,1.557023309,1.923381735,122,17
E2340,Operations,53,76,14.11185969,1,8,10,16,4,1.191117465,1.05877108,129,18
E2341,Finance,55,57,10.59657144,0,8,1,20,3,0.776091455,1.724647678,112,9
E2342,Sales,58,79,17.63758712,3,6,5,21,6,0.590205155,1.126755296,137,11
E2343,HR,55,73,7.878540666,-1,7,4,19,5,1.238942346,2.139991324,128,11
E2344,HR,56,63,12.5791061,1,3,6,29,2,0.66278295,2.135633951,119,9
E2345,Engineering,39,84,9.870541312,0,7,8,21,6,1.379876086,1.931826521,123,15
E2346,Marketing,39,65,9.324664526,0,7,11,14,5,1.74339805,1.355976261,104,18
E2347,HR,35,83,4.305882473,-2,11,3,21,10,2.638580871,3.957871307,118,14
E2348,HR,61,69,10.21834576,0,12,6,23,10,1.604514639,2.050213149,130,18
E2349,Finance,54,77,7.077184094,-1,9,5,16,12,1.73327732,1.980888366,131,14
E2350,Finance,56,70,9.07093774,0,12,11,20,4,2.283799244,1.985912386,126,23
E2351,Operations,48,59,7.195118717,-1,9,8,21,7,2.074405581,2.562501011,107,17
E2352,Support,40,82,7.596520968,-1,7,5,18,9,1.395913538,2.093870307,122,12
E2353,Support,46,64,6.781977933,-1,11,4,18,1,1.927530524,2.313036628,110,15
E2354,Sales,41,73,6.812929601,-1,9,9,22,8,2.303873312,2.81584516,114,18
E2355,Support,38,70,5.226489682,-2,12,10,20,1,3.533291007,3.212082734,108,22
E2356,Engineering,59,69,11.12863943,0,10,6,21,11,1.319191661,1.731439055,128,16
E2357,Sales,46,70,10.05429209,0,2,2,27,5,0.361850399,2.442490192,116,4
E2358,Operations,41,65,12.12337629,1,12,3,21,1,1.142998545,1.600197963,106,15
E2359,Finance,59,68,8.82432276,0,11,8,16,2,1.933975549,1.628610988,127,19
E2360,Support,52,76,8.020741231,-1,10,4,23,11,1.551978894,2.549679612,128,14
E2361,Marketing,53,69,9.736401796,0,12,6,25,8,1.676539342,2.328526864,122,18
E2362,Finance,56,66,12.1050995,1,9,5,26,9,1.068286433,1.983960518,122,14
E2363,Engineering,47,67,10.89951962,0,10,3,23,1,1.092481076,1.932851134,114,13
E2364,Finance,62,85,10.0388217,0,11,4,23,10,1.358840681,2.083555711,147,15
E2365,Engineering,49,76,11.99314918,1,3,5,19,12,0.615709086,1.462309078,125,8
E2366,Engineering,34,72,10.01514896,0,9,4,17,7,1.180192845,1.543329106,106,13
E2367,Engineering,48,60,8.22542066,-1,9,5,16,4,1.517545976,1.734338258,108,14
E2368,Operations,45,87,12.72262062,1,6,5,24,4,0.80159616,1.748937077,132,11
E2369,Engineering,42,55,6.254915611,-1,9,2,22,6,1.516213363,3.032426727,97,11
E2370,Engineering,57,63,5.738943145,-1,11,4,23,10,2.225868312,3.412998078,120,15
E2371,Marketing,40,81,9.92517339,0,8,8,18,4,1.464507649,1.647571106,121,16
E2372,Sales,54,72,10.25750015,0,10,3,19,11,1.154785684,1.687763691,126,13
E2373,HR,48,62,10.69906875,0,10,3,24,9,1.111199556,2.051445334,110,13
E2374,Sales,71,87,9.017158902,0,9,6,17,9,1.497430574,1.697087983,158,15
E2375,Engineering,48,59,14.0592559,1,7,6,18,7,0.863256464,1.195278181,107,13
E2376,Marketing,52,86,5.504367839,-2,7,4,15,1,1.691171267,2.306142637,138,11
E2377,Finance,42,66,10.40495306,0,11,4,16,6,1.315218039,1.402899241,108,15
E2378,Marketing,53,66,12.2759385,1,13,6,24,5,1.431160592,1.8077818,119,19
E2379,Engineering,41,64,14.15305521,1,13,4,21,5,1.121885967,1.385859136,105,17
E2380,Marketing,52,66,14.00298318,1,8,6,25,12,0.93314775,1.666335268,118,14
E2381,Support,57,72,6.711439371,-1,14,5,14,12,2.463872059,1.815484675,129,19
E2382,Marketing,58,53,11.08641466,0,7,5,18,8,0.992850265,1.489275397,111,12
E2383,Engineering,47,66,9.357865273,0,9,1,16,5,0.965449901,1.544719841,113,10
E2384,Operations,51,49,9.943154316,0,12,5,24,3,1.553482617,2.193151929,100,17
E2385,Support,45,61,13.40179,1,6,6,30,2,0.833229758,2.083074396,106,12
E2386,Marketing,53,80,15.69978856,2,5,8,29,4,0.77845297,1.736548933,133,13
E2387,HR,57,72,10.78273239,0,15,7,24,12,1.867139071,2.036878986,129,22
E2388,HR,38,67,4.042816861,-2,3,4,21,5,1.388113071,4.164339213,105,7
E2389,Marketing,46,63,4.994813222,-2,9,3,22,7,2.001730422,3.669839107,109,12
E2390,Operations,66,79,9.86050092,0,5,7,18,11,1.104921411,1.657382116,145,12
E2391,Finance,42,63,12.99269366,1,7,3,23,4,0.714658682,1.643714968,105,10
E2392,Engineering,45,70,7.64369355,-1,6,3,16,9,1.04122155,1.851060534,115,9
E2393,HR,53,77,9.426473945,0,4,4,22,7,0.767277609,2.110013425,130,8
E2394,Finance,44,71,14.85372551,2,8,3,21,6,0.693843223,1.324609789,115,11
E2395,Marketing,46,66,8.810559818,0,9,3,19,9,1.223171789,1.936688665,112,12
E2396,Finance,41,66,15.25854919,2,12,6,20,8,1.107109853,1.230122059,107,18
E2397,Support,57,63,8.709170925,0,9,5,24,4,1.441935682,2.471889741,120,14
E2398,Sales,46,66,12.71281069,1,11,6,16,5,1.239716669,1.166792159,112,17
E2399,HR,55,59,10.2305606,0,8,5,26,11,1.157555751,2.315111501,114,13
E2400,Marketing,53,69,12.32990322,1,13,3,23,1,1.200308789,1.725443885,122,16
E2401,Engineering,63,68,16.02592312,2,10,6,24,2,0.939743466,1.409615198,131,16
E2402,Operations,47,77,11.2590119,0,10,3,20,4,1.060444357,1.631452857,124,13
E2403,Support,60,68,13.78322079,1,11,4,21,3,1.014663869,1.420529416,128,15
E2404,Marketing,53,80,7.316105734,-1,9,10,20,11,2.284723236,2.404971827,133,19
E2405,Engineering,50,81,7.20571661,-1,9,5,21,12,1.70612765,2.559191476,131,14
E2406,Operations,47,74,5.102699367,-2,10,4,25,3,2.294066799,4.096547855,121,14
E2407,Operations,48,67,6.833059581,-1,5,5,14,1,1.27664036,1.787296503,115,10
E2408,Marketing,61,69,14.55179996,2,4,3,30,8,0.45010867,1.929037159,130,7
E2409,Support,50,65,10.99438645,0,15,3,16,2,1.500702023,1.333957354,115,18
E2410,Finance,53,70,9.197793774,0,13,5,21,4,1.765087665,2.059268942,123,18
E2411,Finance,57,62,10.61258504,0,3,6,21,8,0.775021235,1.808382882,119,9
E2412,Operations,45,78,12.04058966,1,2,2,19,3,0.306734596,1.45698933,123,4
E2413,Finance,49,64,12.33551795,1,6,5,35,3,0.824864849,2.624569973,113,11
E2414,Sales,60,82,10.65573219,0,6,6,28,1,1.029536352,2.402251489,142,12
E2415,Operations,51,55,14.1481523,1,8,3,13,12,0.72616117,0.858190474,106,11
E2416,Operations,50,47,7.087715671,-1,8,4,21,3,1.483731685,2.596530449,97,12
E2417,Engineering,47,84,8.948002379,0,8,4,20,7,1.206272329,2.010453882,131,12
E2418,Finance,48,77,13.51078832,1,5,7,28,10,0.826970922,1.929598818,125,12
E2419,Support,51,65,12.86907191,1,6,5,23,10,0.793131658,1.658366194,116,11
E2420,Operations,46,74,11.11248662,0,7,5,20,2,0.990713168,1.651188614,120,12
E2421,Support,52,69,8.371249711,-1,7,7,24,6,1.493930952,2.561024489,121,14
E2422,Sales,53,83,12.36270235,1,10,3,19,7,0.972857111,1.421868085,136,13
E2423,Engineering,68,76,7.272515317,-1,3,8,20,4,1.329704398,2.41764436,144,11
E2424,Marketing,40,73,13.54604671,1,7,4,17,10,0.756219213,1.168702421,113,11
E2425,Support,49,85,14.5651687,2,4,6,18,5,0.64246011,1.156428199,134,10
E2426,Operations,48,80,8.271644757,-1,6,11,13,6,1.833547385,1.402124471,128,17
E2427,Sales,53,72,17.76498793,3,9,7,19,10,0.852651761,1.012523966,125,16
E2428,HR,36,64,7.007996271,-1,14,5,28,4,2.372628477,3.496505125,100,19
E2429,Sales,50,65,9.432915727,0,9,6,19,1,1.437757228,1.821159156,115,15
E2430,Sales,30,69,9.359070281,0,11,6,23,3,1.641073913,2.22027647,99,17
E2431,Engineering,50,67,9.688557709,0,10,9,18,10,1.777601854,1.684043862,117,19
E2432,Marketing,41,57,14.27448936,1,5,6,20,7,0.720155007,1.309372741,98,11
E2433,HR,48,85,11.31319052,0,14,7,16,9,1.705488107,1.29941951,133,21
E2434,Finance,48,79,7.505782207,-1,8,5,17,8,1.528372075,1.998640406,127,13
E2435,Finance,46,78,10.32710697,0,10,3,20,8,1.147689347,1.765675918,124,13
E2436,Support,50,59,11.98963843,1,8,2,19,6,0.769844369,1.462704301,109,10
E2437,Sales,57,69,11.56246956,1,6,2,20,5,0.636817464,1.592043659,126,8
E2438,Engineering,45,58,13.66654635,1,4,4,26,11,0.54545902,1.772741815,103,8
E2439,Engineering,47,98,10.26816794,0,7,5,23,11,1.064946854,2.041148137,145,12
E2440,Finance,62,67,12.39878913,1,14,5,35,10,1.418038586,2.612176344,129,19
E2441,Support,49,81,9.572959967,0,18,6,32,3,2.269941443,3.02658859,130,24
E2442,Support,53,69,8.059717896,-1,8,7,25,10,1.655680693,2.759467821,122,15
E2443,Support,53,81,6.575896238,-1,8,6,27,2,1.847966176,3.563934768,134,14
E2444,HR,61,80,14.69945846,2,9,6,18,1,0.955446969,1.146536363,141,15
E2445,Marketing,54,73,5.473472227,-2,3,4,17,5,1.081336222,2.626102253,127,7
E2446,HR,53,80,10.76213779,0,7,3,15,12,0.850185585,1.275278377,133,10
E2447,Operations,55,74,11.22893107,0,10,7,24,12,1.390146032,1.962559104,129,17
E2448,Operations,55,71,7.057936184,-1,10,6,19,10,1.985620094,2.357923861,126,16
E2449,Marketing,36,59,12.70285161,1,5,9,28,1,1.02168515,2.043370299,95,14
E2450,Finance,45,66,5.948563133,-1,9,7,22,3,2.302634328,3.166122201,111,16
E2451,Marketing,58,61,8.26094595,-1,11,5,15,9,1.72768528,1.61970495,119,16
E2452,Engineering,54,67,12.89407126,1,3,5,21,11,0.575785157,1.511436037,121,8
E2453,Operations,53,73,6.097715414,-1,8,5,16,6,1.831575266,2.254246482,126,13
E2454,Sales,43,82,12.45093976,1,4,5,33,8,0.669098231,2.453360181,125,9
E2455,Sales,48,71,13.34734986,1,2,7,23,2,0.627293548,1.603083512,119,9
E2456,Finance,57,79,13.21937134,1,6,5,21,1,0.773592569,1.47685854,136,11
E2457,Engineering,50,75,11.12312906,0,12,4,23,5,1.319791279,1.897199963,125,16
E2458,HR,40,63,7.484358147,-1,5,4,15,6,1.060775588,1.767959313,103,9
E2459,Engineering,45,61,7.029304806,-1,10,7,19,12,2.117244321,2.366331888,106,17
E2460,Sales,45,75,8.489879293,-1,11,1,16,11,1.26450502,1.686006693,120,12
E2461,Sales,55,60,0.803262729,-3,5,1,14,8,3.327302174,7.763705073,115,6
E2462,Operations,52,65,10.06964218,0,9,6,23,10,1.35505735,2.077754604,117,15
E2463,Engineering,50,69,9.65463142,0,1,3,18,2,0.375423592,1.689406164,119,4
E2464,Engineering,54,72,10.22765652,0,10,2,12,10,1.068789375,1.068789375,126,12
E2465,Sales,43,71,9.279358345,0,9,8,16,9,1.653799725,1.556517388,114,17
E2466,HR,58,73,10.53008105,0,7,9,17,4,1.387674547,1.474404206,131,16
E2467,Finance,43,70,10.23780483,0,5,3,20,1,0.711882803,1.779707007,113,8
E2468,Support,55,50,5.61974951,-1,7,4,16,1,1.661694296,2.417009885,105,11
E2469,Finance,55,69,10.8398635,0,7,9,17,5,1.351366931,1.435827365,124,16
E2470,Engineering,57,75,9.936733678,0,9,7,23,3,1.462959643,2.103004487,132,16
E2471,Finance,44,70,4.822555834,-2,11,3,21,7,2.404442379,3.606663568,114,14
E2472,Sales,37,60,12.68447688,1,8,6,28,10,1.02305701,2.04611402,97,14
E2473,Sales,45,54,9.105118935,0,11,7,22,11,1.781275422,2.177114405,99,18
E2474,Engineering,61,76,11.90689119,1,7,3,20,11,0.77477991,1.54955982,137,10
E2475,Engineering,50,77,9.867131693,0,11,5,9,12,1.472329631,0.828185418,127,16
E2476,Support,51,78,4.659389736,-2,7,7,21,9,2.473764956,3.710647434,129,14
E2477,Support,47,68,10.75155622,0,9,6,20,2,1.276426689,1.701902253,115,15
E2478,Operations,45,81,11.4892223,0,10,7,17,7,1.361173626,1.361173626,126,17
E2479,Engineering,47,73,13.51163436,1,10,1,18,5,0.758012483,1.240384064,120,11
E2480,HR,46,74,12.7568281,1,6,5,21,8,0.799602926,1.526514676,120,11
E2481,Finance,49,60,13.59495037,1,10,2,18,9,0.822202179,1.233303269,109,12
E2482,Engineering,43,67,12.20903816,1,10,6,18,10,1.21129183,1.362703308,110,16
E2483,Marketing,47,78,8.525063569,-1,2,6,20,11,0.839889408,2.099723519,125,8
E2484,Operations,50,86,8.595915965,0,10,5,14,6,1.563165002,1.458954002,136,15
E2485,Marketing,47,83,12.96681364,1,7,4,17,10,0.787581211,1.217170962,130,11
E2486,Sales,50,72,8.834807585,0,6,7,10,3,1.321835724,1.01679671,122,13
E2487,Support,56,64,11.58950785,1,5,4,31,3,0.714881003,2.462367899,120,9
E2488,Finance,47,79,15.12802042,2,12,2,12,5,0.868054457,0.744046677,126,14
E2489,Engineering,51,64,8.146240304,-1,3,6,25,6,0.984010883,2.733363565,115,9
E2490,Marketing,45,56,12.18490423,1,8,5,31,8,0.985976066,2.351173695,101,13
E2491,Finance,50,84,7.59089155,-1,5,2,22,9,0.814816478,2.560851789,134,7
E2492,Sales,53,75,11.75920843,1,5,6,24,6,0.862122447,1.880994431,128,11
E2493,Support,38,69,14.84107917,2,4,1,18,5,0.315635062,1.136286222,107,5
E2494,HR,52,77,14.01628798,1,7,3,15,3,0.665943542,0.998915313,129,10
E2495,Operations,38,64,8.844695129,0,5,5,23,2,1.015775488,2.336283623,102,10
E2496,Finance,46,71,14.7211992,2,5,2,19,12,0.445258654,1.208559204,117,7
E2497,Finance,44,79,9.325734754,0,9,4,22,2,1.25899031,2.130598986,123,13
E2498,HR,46,81,16.86542502,2,9,3,23,9,0.67168847,1.287402901,127,12
E2499,Finance,54,68,10.09726339,0,4,4,17,7,0.720898452,1.531909211,122,8
E2500,Sales,48,56,11.98849028,1,10,6,21,1,1.231859874,1.616816085,104,16
E2501,Sales,51,66,11.89731037,1,8,3,20,5,0.852891005,1.550710918,117,11
E2502,HR,52,70,6.718240623,-1,7,5,16,1,1.554758472,2.073011297,122,12
E2503,Operations,53,78,14.12879863,1,8,3,14,11,0.727090119,0.925387425,131,11
E2504,Engineering,56,78,10.65863203,0,11,10,15,11,1.801240484,1.286600346,134,21
E2505,Marketing,46,76,8.332302706,-1,8,1,32,6,0.964392207,3.428950068,122,9
E2506,Engineering,57,97,7.746119138,-1,11,5,24,2,1.829382809,2.744074214,154,16
E2507,Finance,47,59,8.191920218,-1,5,5,21,8,1.087911966,2.284615129,106,10
E2508,Marketing,51,61,9.769143956,0,11,3,21,11,1.30001048,1.95001572,112,14
E2509,HR,38,70,6.79838746,-1,12,3,18,4,1.923474574,2.308169489,108,15
E2510,HR,43,55,7.550845385,-1,8,7,18,7,1.754212516,2.10505502,98,15
E2511,Operations,36,74,4.815530979,-2,6,4,22,1,1.719533442,3.782973572,110,10
E2512,Marketing,50,73,7.572136552,-1,15,1,18,9,1.866512497,2.099826559,123,16
E2513,Sales,62,54,14.09312828,1,8,8,17,6,1.060085073,1.12634039,116,16
E2514,Marketing,52,67,13.60379813,1,9,2,20,4,0.753228708,1.369506742,119,11
E2515,Finance,49,63,10.81018108,0,13,3,19,8,1.354763309,1.608781429,112,16
E2516,Sales,58,69,16.318943,2,9,7,19,7,0.923843909,1.097064642,127,16
E2517,Support,58,90,13.64451764,1,6,3,25,7,0.614564455,1.707123486,148,9
E2518,Support,58,72,11.3041165,0,10,3,25,2,1.056556966,2.03184032,130,13
E2519,Support,49,73,11.63051284,1,7,1,13,3,0.633386791,1.029253536,122,8
E2520,HR,53,65,10.26637611,0,10,9,28,3,1.686434024,2.485271193,118,19
E2521,Marketing,44,73,6.221927524,-1,4,4,23,9,1.107737508,3.184745336,117,8
E2522,Support,62,52,9.200478373,0,8,6,18,10,1.372484651,1.764623123,114,14
E2523,Engineering,42,84,2.216216849,-3,7,7,22,11,4.35294032,6.840334788,126,14
E2524,Operations,62,60,6.716864456,-1,8,3,22,9,1.425449425,2.850898849,122,11
E2525,Engineering,51,78,14.16396451,1,8,3,10,3,0.725403967,0.659458151,129,11
E2526,Support,48,72,10.23226709,0,12,6,15,11,1.602525996,1.33543833,120,18
E2527,Operations,43,68,6.80165837,-1,10,5,22,2,1.922668142,2.819913274,111,15
E2528,Finance,46,62,11.58109862,1,7,3,18,4,0.794843145,1.430717662,108,10
E2529,Engineering,50,68,11.81309595,1,7,4,19,3,0.858496654,1.482857857,118,11
E2530,Marketing,65,65,14.62619457,2,12,2,22,2,0.895931504,1.407892363,130,14
E2531,Marketing,46,89,15.33484249,2,13,4,24,1,1.040720166,1.469252,135,17
E2532,Engineering,47,65,12.34367059,1,5,6,30,3,0.824360878,2.248256939,112,11
E2533,Support,47,70,5.456109938,-2,8,3,21,12,1.703812374,3.252732714,117,11
E2534,Marketing,59,65,16.84108196,2,4,8,15,8,0.672604948,0.840756185,124,12
E2535,Finance,40,69,14.06015497,1,8,8,23,6,1.062406066,1.52720872,109,16
E2536,Sales,48,71,12.54759383,1,4,5,22,11,0.664324611,1.623904604,119,9
E2537,Support,52,77,9.949981989,0,5,3,13,3,0.730594809,1.187216565,129,8
E2538,Finance,40,67,5.350474507,-2,3,3,22,10,0.944811288,3.464308057,107,6
E2539,Operations,58,65,8.319914577,-1,6,3,21,6,0.965674087,2.253239536,123,9
E2540,Finance,50,75,9.847262912,0,15,3,29,9,1.659404787,2.67348549,125,18
E2541,Support,58,81,8.797291786,0,8,6,16,1,1.428966321,1.633104367,139,14
E2542,Operations,40,71,13.28036828,1,9,6,16,12,1.050393079,1.120419284,111,15
E2543,Support,55,79,9.77043638,0,10,8,25,4,1.671241477,2.321168718,134,18
E2544,Marketing,43,71,7.670002315,-1,11,5,18,8,1.845443567,2.076124013,114,16
E2545,Sales,57,61,11.50217674,0,7,6,17,12,1.039818927,1.359763212,118,13
E2546,Support,54,66,7.512329741,-1,11,4,29,6,1.762149782,3.406822913,120,15
E2547,Support,40,49,5.10480101,-2,9,2,19,12,1.801860533,3.112304556,89,11
E2548,Marketing,57,65,11.52830467,0,5,8,22,4,1.037650372,1.756023706,122,13
E2549,HR,43,66,9.782507351,0,4,5,23,7,0.834685265,2.133084565,109,9
E2550,Marketing,45,67,10.47045649,0,11,4,22,2,1.307707327,1.917970746,112,15
E2551,Operations,42,71,14.12870662,1,3,8,23,1,0.727094541,1.520288586,113,11
E2552,Marketing,43,74,10.75295199,0,9,2,16,9,0.935935075,1.361360109,117,11
E2553,Marketing,56,51,11.70758177,1,12,3,22,10,1.180397677,1.731249926,107,15
E2554,Sales,53,71,10.05147432,0,15,4,33,1,1.719227629,2.986026935,124,19
E2555,Marketing,57,59,12.42993302,1,8,5,17,1,0.967986958,1.265829098,116,13
E2556,Support,43,65,3.603111892,-2,5,7,24,5,2.606932067,5.213864134,108,12
E2557,Sales,51,68,7.676947039,-1,9,4,21,4,1.498222813,2.420206082,119,13
E2558,Engineering,52,71,8.841511795,0,4,5,23,12,0.914493646,2.337039317,123,9
E2559,HR,45,77,8.561696872,0,4,5,27,3,0.941255524,2.823766572,122,9
E2560,Sales,54,83,7.625160916,-1,7,4,18,5,1.275338525,2.086917586,137,11
E2561,Operations,54,61,9.754042213,0,5,6,26,10,1.022871194,2.41769555,115,11
E2562,Engineering,45,61,9.592961694,0,5,3,26,2,0.755218439,2.454459928,106,8
E2563,Sales,56,70,9.752521306,0,8,3,15,11,1.023015876,1.395021649,126,11
E2564,Sales,52,84,10.60137551,0,13,5,22,5,1.551540159,1.896326861,136,18
E2565,HR,54,71,11.49337201,0,9,7,22,10,1.280679066,1.760933716,125,16
E2566,Support,54,59,7.672127547,-1,10,3,26,4,1.499055443,2.998110885,113,13
E2567,Operations,49,79,8.43296811,-1,8,3,16,5,1.166122886,1.696178744,128,11
E2568,Finance,54,70,12.76818721,1,12,8,16,10,1.45262406,1.162099248,124,20
E2569,Finance,53,66,7.174166515,-1,4,6,23,8,1.223366319,2.813742534,119,10
E2570,Sales,47,57,7.576174795,-1,13,6,19,5,2.21543992,2.21543992,104,19
E2571,Marketing,34,65,7.681103509,-1,7,1,19,9,0.921541828,2.188661842,99,8
E2572,Operations,44,76,9.400350819,0,9,6,14,8,1.442259041,1.346108438,120,15
E2573,Engineering,59,76,12.99440811,1,4,5,24,10,0.643114016,1.714970709,135,9
E2574,Marketing,51,64,11.57169631,1,8,3,19,9,0.874981365,1.511331449,115,11
E2575,Marketing,42,58,7.381206947,-1,6,6,19,12,1.431774693,2.266976597,100,12
E2576,Operations,49,79,15.43969962,2,6,4,20,7,0.60828362,1.21656724,128,10
E2577,Support,62,84,7.913056446,-1,11,9,29,9,2.243899174,3.253653803,146,20
E2578,Sales,56,64,5.136331054,-2,11,6,17,5,2.770385081,2.770385081,120,17
E2579,Sales,52,58,15.47256825,2,4,4,22,3,0.485655902,1.335553732,110,8
E2580,Sales,54,73,7.48944415,-1,8,9,8,4,2.002486818,0.942346738,127,17
E2581,Sales,40,66,9.667290127,0,4,3,16,2,0.656211645,1.499912331,106,7
E2582,Finance,50,80,9.598046077,0,6,5,11,2,1.037927173,1.037927173,130,11
E2583,Sales,47,66,11.74526241,1,5,5,22,2,0.784605266,1.726131584,113,10
E2584,Finance,32,74,4.489074361,-2,8,8,32,11,2.914881262,5.829762524,106,16
E2585,Finance,44,84,9.097938807,0,9,8,21,2,1.683511885,2.079632329,128,17
E2586,Support,48,73,8.899688695,0,6,9,23,1,1.51519916,2.323305379,121,15
E2587,Sales,54,83,14.24113537,1,3,5,14,4,0.524895279,0.918566738,137,8
E2588,HR,48,60,8.369322936,-1,8,5,20,5,1.387506876,2.134625964,108,13
E2589,Engineering,48,90,9.037782627,0,6,4,20,7,0.996235959,1.992471918,138,10
E2590,Marketing,50,68,12.28047859,1,7,11,19,6,1.355372841,1.430671332,118,18
E2591,Finance,63,68,11.53420019,0,7,5,15,2,0.957380592,1.19672574,131,12
E2592,Operations,40,68,7.827870387,-1,6,2,19,7,0.906220827,2.152274463,108,8
E2593,Operations,47,66,11.28521828,0,4,6,21,12,0.813986351,1.709371338,113,10
E2594,Engineering,55,89,7.787864348,-1,11,4,20,5,1.706899357,2.275865809,144,15
E2595,Operations,57,74,12.40969917,1,16,4,19,1,1.491457769,1.41688488,131,20
E2596,HR,55,69,9.519329587,0,2,1,19,1,0.285189277,1.806198755,124,3
E2597,Operations,58,63,6.230052503,-1,4,5,17,5,1.244804239,2.351296895,121,9
E2598,Marketing,63,74,3.570038087,-2,10,5,27,2,3.282248357,5.908047042,137,15
E2599,Marketing,59,64,8.871945286,0,6,3,25,8,0.911674421,2.532428947,123,9
E2600,Finance,50,59,7.648909314,-1,7,5,15,3,1.387458183,1.734322729,109,12
E2601,Sales,53,76,9.281138555,0,5,6,19,3,1.069920412,1.848044348,129,11
E2602,Support,55,65,9.852262682,0,7,1,25,10,0.737173457,2.303667054,120,8
E2603,HR,54,68,4.258759345,-2,8,2,20,10,1.901589204,3.803178409,122,10
E2604,Finance,57,68,7.810381064,-1,6,10,26,8,1.816039498,2.951064183,125,16
E2605,HR,49,54,9.6118966,0,4,3,18,11,0.659637034,1.696209516,103,7
E2606,Sales,53,92,10.30014004,0,12,5,19,1,1.504406135,1.681395092,145,17
E2607,Operations,57,82,12.39468481,1,9,3,16,1,0.895877743,1.194503658,139,12
E2608,Operations,47,61,12.91163562,1,7,6,19,11,0.934469559,1.365763201,108,13
E2609,Support,39,54,9.284044205,0,10,4,20,7,1.361332149,1.944760213,93,14
E2610,Sales,59,71,9.556371802,0,7,4,22,1,1.042024685,2.08404937,130,11
E2611,Finance,49,65,8.557965029,0,9,11,26,7,2.092495624,2.720244312,114,20
E2612,Support,57,82,11.96725812,1,4,7,19,10,0.848290355,1.465228796,139,11
E2613,Sales,56,67,8.846463785,0,5,3,19,12,0.812474425,1.929626759,123,8
E2614,Engineering,42,61,7.099536168,-1,14,5,21,4,2.345813341,2.592741061,103,19
E2615,Marketing,43,70,5.012489159,-2,10,2,20,8,1.995845595,3.326409324,113,12
E2616,Support,63,71,7.157482324,-1,7,5,19,1,1.471042109,2.329150006,134,12
E2617,Support,49,68,9.202390141,0,8,3,32,10,1.078178726,3.136519929,117,11
E2618,Finance,45,67,12.93867285,1,10,3,31,9,0.932656942,2.224028094,112,13
E2619,HR,57,69,10.13654009,0,13,1,13,9,1.257122938,1.167328443,126,14
E2620,Engineering,51,67,10.34345113,0,3,5,20,6,0.705252741,1.763131852,118,8
E2621,Finance,53,65,10.01012064,0,10,6,20,2,1.453208418,1.816510522,118,16
E2622,Sales,44,74,13.83945091,1,8,2,26,6,0.673879382,1.752086392,118,10
E2623,Sales,48,79,11.52358992,0,9,5,13,11,1.117890324,1.038041016,127,14
E2624,Sales,55,91,9.95586412,0,10,7,16,10,1.551680435,1.460405115,146,17
E2625,Sales,44,70,8.204001458,-1,4,1,21,10,0.543241983,2.281616327,114,5
E2626,HR,54,72,6.218519252,-1,13,4,18,8,2.355053634,2.493586201,126,17
E2627,Engineering,44,79,14.95735944,2,7,4,17,9,0.689337108,1.065339166,123,11
E2628,Operations,57,55,12.41085414,1,12,5,12,5,1.267629923,0.894797593,112,17
E2629,Marketing,57,74,9.419805583,0,8,10,20,9,1.727479448,1.919421609,131,18
E2630,HR,64,74,15.38187154,2,9,4,22,5,0.793560123,1.342947901,138,13
E2631,HR,52,67,9.977118163,0,10,5,17,2,1.366478868,1.54867605,119,15
E2632,Operations,42,64,7.549760063,-1,5,4,12,11,1.05266112,1.403548159,106,9
E2633,Operations,48,83,13.66498475,1,9,4,18,3,0.886465293,1.227413482,131,13
E2634,Marketing,56,77,6.157027735,-1,7,8,23,3,2.095842095,3.213624545,133,15
E2635,Marketing,53,57,8.797307912,0,8,10,25,4,1.837239389,2.551721373,110,18
E2636,Operations,53,74,6.398029836,-1,11,8,28,6,2.568251335,3.78479144,127,19
E2637,Sales,53,60,7.601950162,-1,6,7,20,9,1.511285203,2.325054159,113,13
E2638,HR,46,71,10.59949029,0,9,6,15,6,1.293160271,1.293160271,117,15
E2639,Finance,51,68,11.01157211,0,16,4,20,7,1.665060977,1.665060977,119,20
E2640,Marketing,63,65,6.693423058,-1,8,1,12,4,1.169830377,1.559773837,128,9
E2641,Marketing,44,66,15.42748049,2,6,6,19,6,0.73048329,1.156598543,110,12
E2642,Operations,45,73,3.732587735,-2,9,3,16,1,2.535610679,3.380814239,118,12
E2643,Engineering,47,72,10.38871264,0,5,5,14,4,0.878062369,1.229287317,119,10
E2644,Finance,45,70,10.46545518,0,1,8,7,8,0.784966655,0.610529621,115,9
E2645,Finance,52,67,10.79044753,0,7,4,15,9,0.932958649,1.272216339,119,11
E2646,Marketing,51,67,12.63798708,1,6,6,30,3,0.879895246,2.199738116,118,12
E2647,Sales,64,72,0.851507122,-3,8,8,24,3,8.64160867,12.962413,136,16
E2648,Engineering,34,67,7.67784871,-1,8,6,23,8,1.613303074,2.650426479,101,14
E2649,Finance,42,78,10.4538036,0,13,9,26,2,1.92075932,2.269988287,120,22
E2650,Marketing,54,83,15.10923036,2,6,3,16,12,0.558685909,0.993219393,137,9
E2651,Finance,58,83,8.254539253,-1,10,7,20,1,1.836936398,2.161101645,141,17
E2652,Support,51,66,9.422790584,0,9,4,22,11,1.247266737,2.110759093,117,13
E2653,Engineering,50,83,12.17637489,1,6,1,21,9,0.531253858,1.593761575,133,7
E2654,Engineering,58,77,6.371307346,-1,6,4,27,6,1.356611457,3.662850935,135,10
E2655,Support,42,60,10.06733672,0,5,8,16,3,1.174627675,1.4456956,102,13
E2656,HR,48,69,9.684595637,0,9,2,21,8,1.029519541,1.965446397,117,11
E2657,Support,50,51,8.172331008,-1,6,5,25,1,1.199258944,2.725588509,101,11
E2658,Operations,42,82,11.50912222,0,9,4,29,4,1.039241585,2.31830815,124,13
E2659,Operations,63,58,16.47074579,2,10,7,18,9,0.973055198,1.030293739,121,17
E2660,Marketing,44,79,10.52113532,0,11,5,18,3,1.388752024,1.562346027,123,16
E2661,Engineering,57,64,3.295284505,-2,7,9,24,1,3.725015184,5.587522776,121,16
E2662,HR,53,77,7.386649644,-1,6,5,24,7,1.311608386,2.861691023,130,11
E2663,HR,46,74,14.43792831,1,4,0,22,11,0.259102123,1.425061677,120,4
E2664,Finance,44,73,9.281377016,0,18,6,14,7,2.334317666,1.361685305,117,24
E2665,Finance,53,66,6.481235139,-1,10,6,31,7,2.138684282,4.143700796,119,16
E2666,Support,48,60,12.26364617,1,9,8,29,8,1.281698846,2.186427444,108,17
E2667,HR,57,81,8.083997942,-1,10,6,21,6,1.761339016,2.311757459,138,16
E2668,Support,50,59,10.10517059,0,13,5,15,10,1.620866591,1.350722159,109,18
E2669,Support,49,73,6.604893649,-1,8,7,17,12,1.972414171,2.235402727,122,15
E2670,Finance,40,72,8.745820409,0,10,3,19,7,1.333905146,1.949553675,112,13
E2671,Engineering,56,64,9.909541413,0,7,3,19,11,0.916628813,1.741594745,120,10
E2672,Support,42,68,9.697628716,0,8,5,14,12,1.215222583,1.308701243,110,13
E2673,Sales,47,64,11.12394398,0,10,4,21,12,1.154739747,1.73210962,111,14
E2674,Engineering,48,73,10.60362112,0,12,4,19,7,1.378879906,1.637419889,121,16
E2675,HR,58,82,6.944591794,-1,12,5,25,9,2.139820452,3.146794782,140,17
E2676,HR,41,74,15.05745096,2,7,8,18,7,0.934145777,1.120974932,115,15
E2677,Support,49,73,9.529689233,0,9,6,24,4,1.424543466,2.279269546,122,15
E2678,Engineering,45,73,5.948385193,-1,10,2,18,3,1.727019972,2.590529958,118,12
E2679,Finance,58,87,3.33305226,-2,6,8,20,11,3.230978802,4.615684003,145,14
E2680,Finance,44,64,10.22554699,0,7,5,22,2,1.068990224,1.959815412,108,12
E2681,Operations,56,60,7.221202986,-1,5,9,27,4,1.702913798,3.284190896,116,14
E2682,HR,45,83,11.71841538,1,6,5,18,6,0.864887619,1.41527065,128,11
E2683,Marketing,49,54,10.14507874,0,7,10,16,2,1.525336913,1.435611212,103,17
E2684,Operations,42,60,21.81550893,4,5,4,15,11,0.394468518,0.65744753,102,9
E2685,Finance,56,58,6.217411217,-1,5,7,29,5,1.662646015,4.018061203,114,12
E2686,Engineering,67,77,13.17306021,1,13,4,23,3,1.199458674,1.622797029,144,17
E2687,Finance,44,62,6.731204941,-1,10,4,18,12,1.810843214,2.328226989,106,14
E2688,Engineering,56,68,12.49287045,1,8,6,15,9,1.037585001,1.111698215,124,14
E2689,Operations,60,83,14.26936429,1,11,4,20,7,0.982359168,1.309812224,143,15
E2690,HR,53,69,8.966834661,0,10,5,23,2,1.504991355,2.307653411,122,15
E2691,Finance,49,72,7.812396133,-1,5,7,23,2,1.361718177,2.60995984,121,12
E2692,Support,49,76,9.530253795,0,9,1,22,9,0.949644728,2.089218401,125,10
E2693,Engineering,49,62,7.77098326,-1,8,5,19,10,1.482159937,2.166233755,111,13
E2694,HR,53,61,14.8318461,2,10,5,22,1,0.947457416,1.38960421,114,15
E2695,Marketing,51,73,9.407261264,0,6,6,19,8,1.153041102,1.825648412,124,12
E2696,Engineering,45,75,11.31859401,0,8,4,24,6,0.974137145,1.94827429,120,12
E2697,Operations,36,53,11.40666362,0,5,3,12,4,0.644814774,0.967222161,89,8
E2698,Marketing,56,64,12.67656594,1,12,7,20,6,1.389237626,1.462355396,120,19
E2699,Marketing,60,64,8.643967845,0,8,3,22,7,1.140609361,2.281218722,124,11
E2700,Sales,45,67,12.30215194,1,13,6,17,12,1.428340323,1.27798871,112,19
E2701,Finance,55,64,13.90411969,1,9,5,23,6,0.939337599,1.543197484,119,14
E2702,Engineering,61,66,9.532966194,0,10,3,18,6,1.234220234,1.708920324,127,13
E2703,Marketing,50,80,6.001006791,-1,15,4,18,2,2.713895382,2.571058783,130,19
E2704,Sales,65,78,14.10578441,1,6,4,19,9,0.661998062,1.257796317,143,10
E2705,Operations,44,82,10.52092177,0,11,6,21,5,1.475576376,1.822770817,126,17
E2706,HR,49,48,10.01259586,0,4,4,29,12,0.726440896,2.633348247,97,8
E2707,Support,47,62,12.03028749,1,12,6,22,8,1.381396997,1.688374107,109,18
E2708,Support,61,69,14.2875444,1,9,6,25,11,0.981190936,1.635318226,130,15
E2709,Engineering,41,51,9.334065933,0,7,7,23,9,1.354742663,2.22564866,92,14
E2710,Marketing,55,66,13.76692488,1,8,4,19,5,0.812626874,1.286659217,121,12
E2711,Support,52,50,10.21630941,0,5,4,22,9,0.802402972,1.961429486,102,9
E2712,Finance,47,68,11.8714106,1,8,5,22,7,1.009990311,1.709214372,115,13
E2713,Support,60,74,8.179174627,-1,6,6,26,7,1.307307082,2.832498678,134,12
E2714,Support,47,61,9.238524649,0,15,4,23,4,1.855736119,2.246417408,108,19
E2715,Support,52,68,13.25402946,1,12,5,24,3,1.192645213,1.683734418,120,17
E2716,Sales,46,62,4.106920416,-2,4,1,18,7,0.979063622,3.524629039,108,5
E2717,Marketing,48,72,12.10134271,1,13,7,27,3,1.52656109,2.060857471,120,20
E2718,Finance,44,60,11.13856302,0,8,4,21,12,0.988584891,1.73002356,104,12
E2719,Marketing,46,66,14.98306872,2,6,8,22,8,0.87592691,1.376456573,112,14
E2720,Engineering,50,77,13.01829365,1,10,1,26,8,0.784688941,1.854719316,127,11
E2721,Engineering,42,60,10.53056139,0,11,7,20,10,1.561068833,1.734520925,102,18
E2722,Engineering,43,68,6.184480702,-1,9,7,17,1,2.227022476,2.36621138,111,16
E2723,Operations,51,65,8.258255461,-1,7,9,13,11,1.728187353,1.404152224,116,16
E2724,Support,34,70,9.319239441,0,15,3,22,9,1.744314598,2.131940065,104,18
E2725,Operations,44,75,14.47607408,1,4,4,11,1,0.516926965,0.710774576,119,8
E2726,Sales,49,70,12.40230162,1,2,7,19,4,0.671526448,1.417666945,119,9
E2727,Engineering,59,64,7.614899566,-1,8,7,13,1,1.741169457,1.509013529,123,15
E2728,Finance,56,73,11.20842732,0,3,6,21,11,0.73719569,1.720123277,129,9
E2729,Marketing,51,77,8.623698953,0,6,4,17,9,1.039101498,1.766472547,128,10
E2730,Support,62,73,8.062547197,-1,12,4,19,3,1.765508047,2.096540806,135,16
E2731,HR,52,60,11.88570712,1,7,8,14,9,1.16408047,1.086475106,112,15
E2732,Finance,53,71,9.566764478,0,6,7,16,3,1.230272524,1.514181567,124,13
E2733,Support,37,74,6.507215729,-1,10,2,19,6,1.598462124,2.530898363,111,12
E2734,Operations,55,58,12.48079608,1,13,1,18,11,1.038514337,1.335232719,113,14
E2735,Operations,53,69,10.45600499,0,12,4,23,10,1.396647437,2.00768069,122,16
E2736,Finance,56,49,8.900938311,0,6,5,21,6,1.111005811,2.121011094,105,11
E2737,Operations,41,57,14.47741113,1,13,4,19,9,1.098374906,1.227595483,98,17
E2738,Engineering,48,64,13.19237257,1,14,5,29,8,1.338747267,2.043351092,112,19
E2739,Sales,58,86,10.36479296,0,11,9,19,8,1.759820885,1.671829841,144,20
E2740,Marketing,46,67,4.864182978,-2,7,4,28,5,1.875794129,4.774748691,113,11
E2741,Sales,39,91,13.3315723,1,9,6,24,12,1.046640221,1.674624354,130,15
E2742,Support,35,72,8.549736686,0,9,4,19,1,1.361294078,1.989583653,107,13
E2743,Marketing,38,64,9.526386641,0,9,9,17,5,1.70998849,1.61498913,102,18
E2744,Marketing,35,72,9.091819032,0,5,3,21,8,0.79272131,2.080893438,107,8
E2745,Sales,46,61,6.113165443,-1,6,4,19,4,1.405843865,2.671103344,107,10
E2746,Finance,53,65,11.35751848,0,5,9,20,3,1.132913539,1.618447913,118,14
E2747,Marketing,41,53,7.47198927,-1,9,3,17,2,1.416432389,2.006612551,94,12
E2748,Sales,52,69,11.20206048,0,4,4,17,10,0.655626975,1.393207322,121,8
E2749,Marketing,51,63,7.191780353,-1,6,5,21,11,1.342809441,2.563545297,114,11
E2750,HR,45,79,8.636971242,0,10,4,24,4,1.452738588,2.490409009,124,14
E2751,Finance,47,77,11.09534971,0,9,6,17,4,1.240146037,1.405498842,124,15
E2752,Engineering,52,66,10.37067553,0,5,4,16,2,0.791509702,1.407128359,118,9
E2753,Marketing,42,69,11.86511252,1,11,1,15,2,0.932755153,1.165943942,111,12
E2754,HR,49,82,12.09166236,1,6,4,19,9,0.763844936,1.451305379,131,10
E2755,Engineering,55,72,13.99698482,1,5,4,24,3,0.600120631,1.600321684,127,9
E2756,Engineering,73,70,9.997765555,0,12,6,19,8,1.636696101,1.727623662,143,18
E2757,Support,52,76,13.62093741,1,9,6,24,8,1.025926011,1.641481618,128,15
E2758,Marketing,41,70,9.032785288,0,10,4,21,9,1.395425059,2.093137588,111,14
E2759,Sales,45,73,12.33358662,1,11,5,18,7,1.199977205,1.349974355,118,16
E2760,Marketing,47,60,13.3706919,1,4,4,25,1,0.556688575,1.739651798,107,8
E2761,HR,54,72,13.3593927,1,10,8,21,9,1.253534907,1.462457392,126,18
E2762,Engineering,37,75,5.623570986,-1,8,6,16,12,2.113663465,2.415615389,112,14
E2763,Marketing,49,71,0.565113031,-3,7,6,23,4,8.306109362,14.69542426,120,13
E2764,Sales,49,66,11.66524302,1,6,6,25,6,0.947474911,1.973906064,115,12
E2765,Support,55,69,10.00754655,0,7,10,19,8,1.544395014,1.726088545,124,17
E2766,Marketing,45,78,10.84124827,0,5,7,17,12,1.013406672,1.435659452,123,12
E2767,Finance,46,78,10.2750103,0,10,7,19,6,1.507759155,1.685142585,124,17
E2768,Support,40,77,8.982282112,0,5,4,16,6,0.90159744,1.602839894,117,9
E2769,Sales,46,82,11.71775181,1,6,3,22,6,0.707672247,1.729865492,128,9
E2770,HR,53,65,11.01682878,0,8,0,15,12,0.665733044,1.248249457,118,8
E2771,Engineering,38,61,9.685588046,0,5,5,24,12,0.935839933,2.246015839,99,10
E2772,Marketing,54,72,10.08681361,0,7,7,16,8,1.262761375,1.443155857,126,14
E2773,Sales,42,65,11.85068583,1,10,3,14,3,1.011619159,1.089436018,107,13
E2774,Support,56,75,8.217459288,-1,9,2,25,1,1.193387425,2.712244147,131,11
E2775,Finance,38,65,6.664847422,-1,7,3,33,10,1.304657412,4.305369459,103,10
E2776,Sales,49,59,6.61859351,-1,8,9,20,1,2.231382994,2.625156464,108,17
E2777,Operations,53,50,8.474302622,-1,8,5,22,6,1.372132654,2.322070645,103,13
E2778,Finance,54,58,14.45333296,1,1,10,29,5,0.711820552,1.87661782,112,11
E2779,Support,58,84,10.39830824,0,7,6,21,7,1.140520131,1.842378673,142,13
E2780,HR,52,78,7.962940211,-1,5,8,20,4,1.450416905,2.231410623,130,13
E2781,Engineering,37,78,10.60690835,0,5,6,23,6,0.947711455,1.981578497,115,11
E2782,Support,52,62,6.867128101,-1,5,6,26,6,1.398223069,3.304890891,114,11
E2783,HR,51,91,9.442498114,0,6,1,16,2,0.670337684,1.53220042,142,7
E2784,Marketing,42,69,8.76873549,0,9,5,22,1,1.433143523,2.25208268,111,14
E2785,Sales,41,79,6.030162499,-1,6,5,19,1,1.564686449,2.702640231,120,11
E2786,Operations,57,90,13.2796916,1,3,5,19,8,0.560236189,1.330560948,147,8
E2787,Finance,44,61,8.870120116,0,9,3,13,6,1.215790675,1.317106565,105,12
E2788,Finance,45,83,9.884696555,0,8,2,17,8,0.918721064,1.561825809,128,10
E2789,Sales,45,71,12.09044209,1,5,4,27,3,0.687524527,2.06257358,116,9
E2790,Operations,45,64,11.05535441,0,10,7,22,8,1.410161778,1.824915242,109,17
E2791,Sales,42,62,10.23160755,0,13,4,26,5,1.513585648,2.314895698,104,17
E2792,Marketing,42,66,9.285865525,0,14,1,20,11,1.458311891,1.944415854,108,15
E2793,HR,44,69,12.18457406,1,7,7,22,12,1.061846969,1.668616666,113,14
E2794,Support,52,75,9.978344838,0,9,3,23,11,1.093060947,2.095033481,127,12
E2795,Finance,52,82,10.43255335,0,7,3,31,8,0.874695241,2.711555246,134,10
E2796,Marketing,37,63,13.338638,1,10,3,26,1,0.906641202,1.813282405,100,13
E2797,HR,45,72,13.50857538,1,12,4,26,1,1.102796076,1.792043623,117,16
E2798,Marketing,42,60,10.80616237,0,4,3,19,1,0.5929107,1.609329044,102,7
E2799,Operations,48,64,10.31383281,0,9,6,19,6,1.325810648,1.679360154,112,15
E2800,Finance,49,97,11.96745831,1,12,5,15,12,1.310973947,1.156741718,146,17
E2801,Support,39,73,9.245031635,0,8,3,22,9,1.07369117,2.147382339,112,11
E2802,Sales,46,65,9.252902402,0,10,5,16,7,1.463000369,1.560533727,111,15
E2803,Sales,63,61,9.811944305,0,9,5,26,6,1.294864236,2.404747867,124,14
E2804,HR,53,59,6.944615152,-1,13,9,25,10,2.769171266,3.14678553,112,22
E2805,Support,50,68,17.087152,2,3,3,19,5,0.331727184,1.050469416,118,6
E2806,Engineering,52,69,8.800901182,0,8,11,16,11,1.938597242,1.632502941,121,19
E2807,Operations,53,64,11.40289383,0,9,8,20,4,1.37064787,1.612526905,117,17
E2808,HR,58,81,9.94920755,0,8,5,24,4,1.187300537,2.191939452,139,13
E2809,Engineering,46,77,12.06385912,1,5,5,18,5,0.765470594,1.37784707,123,10
E2810,Marketing,42,80,8.847817257,0,6,6,28,6,1.218544139,2.843269658,122,12
E2811,Operations,54,64,10.65042979,0,5,9,27,3,1.201672406,2.317511069,118,14
E2812,Marketing,55,56,7.449343414,-1,8,5,22,1,1.53858109,2.603752614,111,13
E2813,Support,44,70,13.64260029,1,3,7,18,1,0.682938809,1.229289856,114,10
E2814,Finance,66,65,11.98467924,1,8,8,21,6,1.232221429,1.617290625,131,16
E2815,Operations,46,71,5.75090434,-1,11,5,22,7,2.37005284,3.258822654,117,16
E2816,Engineering,42,82,10.04241343,0,6,7,20,6,1.177278869,1.811198261,124,13
E2817,Finance,37,65,5.828565868,-1,12,6,24,3,2.63598541,3.514647214,102,18
E2818,Sales,49,72,7.601512168,-1,9,4,22,8,1.511362159,2.557689807,121,13
E2819,Engineering,53,77,12.76295449,1,4,6,28,11,0.726588176,2.034446893,130,10
E2820,HR,44,67,2.541861867,-2,5,6,19,1,3.10571118,5.36441022,111,11
E2821,Sales,54,62,13.13577802,1,5,1,15,3,0.424454883,1.061137206,116,6
E2822,Sales,62,60,11.13638868,0,6,2,20,12,0.65917467,1.647936675,122,8
E2823,HR,35,68,9.759643065,0,9,8,21,12,1.579978062,1.951737606,103,17
E2824,Operations,61,62,12.6336774,1,6,6,20,12,0.880173386,1.466955644,123,12
E2825,Sales,56,89,18.10840849,3,9,7,18,9,0.837327714,0.941993678,145,16
E2826,Support,50,80,6.012313281,-1,7,3,28,5,1.426062927,3.992976194,130,10
E2827,Engineering,58,81,15.08053902,2,9,8,21,11,1.057178493,1.305926373,139,17
E2828,Finance,44,72,12.8992218,1,12,4,19,9,1.151143584,1.366983006,116,16
E2829,Sales,59,72,7.88564059,-1,7,5,16,1,1.350493516,1.800658021,131,12
E2830,Engineering,48,68,11.57436519,1,5,7,21,1,0.95432253,1.670064427,116,12
E2831,Marketing,54,79,6.66362517,-1,3,7,18,5,1.304865488,2.348757879,133,10
E2832,Engineering,48,72,8.522166346,-1,8,3,20,9,1.155199311,2.100362383,120,11
E2833,Finance,49,63,3.684887931,-2,9,6,18,12,3.201784166,3.842141,112,15
E2834,Engineering,48,70,5.954269018,-1,10,5,15,4,2.156948482,2.156948482,118,15
E2835,HR,57,67,11.14509484,0,10,4,17,3,1.15272875,1.399742054,124,14
E2836,Finance,54,62,11.41066752,0,11,7,17,3,1.450365178,1.369789334,116,18
E2837,Operations,62,59,11.37745504,0,7,11,15,8,1.454256949,1.211880791,121,18
E2838,Marketing,52,66,11.90853918,1,8,4,20,11,0.929617196,1.549361994,118,12
E2839,HR,57,70,10.3553572,0,12,1,27,10,1.144834088,2.377732337,127,13
E2840,Operations,54,85,12.03506567,1,6,6,18,1,0.920593751,1.380890627,139,12
E2841,Engineering,50,82,13.21929124,1,1,10,19,8,0.773596927,1.336212873,132,11
E2842,Finance,48,80,10.73921395,0,12,5,21,12,1.448137845,1.788876162,128,17
E2843,Marketing,51,61,8.69687271,0,8,8,20,10,1.650016503,2.062520629,112,16
E2844,HR,67,62,9.563851935,0,11,3,24,6,1.32527416,2.27189856,129,14
E2845,Operations,47,66,7.491253284,-1,11,6,20,1,2.002060171,2.355364907,113,17
E2846,Operations,45,66,12.55418201,1,10,5,16,3,1.106669513,1.18044748,111,15
E2847,Marketing,59,59,5.183645889,-2,5,7,20,10,1.940602715,3.234337858,118,12
E2848,Support,52,80,9.521924125,0,8,3,20,11,1.045436164,1.900793026,132,11
E2849,Engineering,35,72,11.70740644,1,6,4,22,2,0.786942642,1.731273813,107,10
E2850,Marketing,52,76,6.939763973,-1,9,4,18,7,1.637328269,2.267069911,128,13
E2851,Operations,52,77,5.806000231,-1,4,0,12,1,0.587716701,1.763150102,129,4
E2852,Sales,54,76,3.161084785,-2,7,10,18,5,4.08547311,4.325795058,130,17
E2853,HR,48,68,9.147018178,0,9,3,17,8,1.182613433,1.67536903,116,12
E2854,Marketing,41,64,6.569470736,-1,6,2,23,5,1.056877063,3.038521556,105,8
E2855,Support,52,79,12.63025056,1,7,5,22,9,0.880394674,1.614056902,131,12
E2856,Operations,46,58,5.345312818,-2,9,6,21,7,2.363949648,3.309529507,104,15
E2857,Engineering,49,69,11.586023,1,10,2,22,8,0.953438588,1.747970744,118,12
E2858,Operations,45,78,6.093881757,-1,4,6,23,5,1.409665447,3.242230529,123,10
E2859,Engineering,45,77,5.460689595,-2,14,11,17,5,3.869555971,2.63129806,122,25
E2860,Marketing,53,65,6.389506253,-1,9,7,22,12,2.165232622,2.977194855,118,16
E2861,Engineering,56,60,13.22600055,1,8,7,20,6,1.054407382,1.40587651,116,15
E2862,Finance,61,58,6.391521619,-1,5,4,21,11,1.217611267,2.841092955,119,9
E2863,Finance,40,87,13.42576801,1,10,5,19,6,1.039805991,1.317087589,127,15
E2864,Finance,43,60,10.60795503,0,4,5,12,7,0.775330364,1.033773819,103,9
E2865,Support,50,71,8.44487511,-1,8,10,20,1,1.905795449,2.117550499,121,18
E2866,Support,61,73,6.84319637,-1,6,2,12,3,1.019992312,1.529988468,134,8
E2867,Sales,59,70,15.713294,2,8,0,15,11,0.478660879,0.897489148,129,8
E2868,Support,41,73,8.234946552,-1,9,5,28,1,1.51598062,3.03196124,114,14
E2869,Marketing,53,66,8.24744949,-1,7,5,25,7,1.297655101,2.703448127,119,12
E2870,Operations,41,72,14.35349885,1,9,4,18,3,0.846712539,1.172371208,113,13
E2871,Operations,37,72,14.88521437,2,9,4,20,1,0.818371078,1.259032427,109,13
E2872,Sales,57,80,9.58015949,0,9,2,23,8,1.03968187,2.173880273,137,11
E2873,Support,50,82,13.55270485,1,4,1,21,9,0.34357874,1.443030709,132,5
E2874,Engineering,45,70,8.162402754,-1,9,5,31,7,1.527983475,3.383391981,115,14
E2875,Sales,46,64,16.74091723,2,10,7,32,4,0.958236814,1.803739885,110,17
E2876,Engineering,51,79,6.066198251,-1,7,5,27,12,1.698225775,3.821007993,130,12
E2877,Engineering,49,63,7.257786406,-1,8,2,20,6,1.210978283,2.421956565,112,10
E2878,HR,58,57,13.93821581,1,8,4,9,11,0.803308786,0.602481589,115,12
E2879,Operations,58,62,9.132194087,0,5,1,19,11,0.592171838,1.875210822,120,6
E2880,Finance,55,88,14.11649054,1,10,7,17,2,1.124599652,1.124599652,143,17
E2881,Support,52,74,8.601421769,0,8,5,18,7,1.353966143,1.874722352,126,13
E2882,Engineering,56,57,11.97779083,1,7,6,25,6,1.001711322,1.926367926,113,13
E2883,HR,49,73,7.921024268,-1,8,4,30,12,1.34513702,3.36284255,122,12
E2884,Operations,58,65,9.772770082,0,13,5,21,4,1.670879436,1.949359342,123,18
E2885,Finance,47,57,6.158498686,-1,9,5,17,3,1.955717339,2.374799626,104,14
E2886,Engineering,58,87,9.856418732,0,7,3,30,12,0.921114066,2.763342198,145,10
E2887,Engineering,47,68,7.366553389,-1,10,7,17,6,2.03190002,2.03190002,115,17
E2888,Sales,44,77,16.21765234,2,5,6,17,8,0.638879203,0.987358768,121,11
E2889,Sales,37,80,9.037928707,0,7,3,26,8,0.996221461,2.590175798,117,10
E2890,Operations,64,81,6.407021888,-1,9,3,17,8,1.620084318,2.29511945,145,12
E2891,Finance,55,78,12.07552459,1,5,5,21,9,0.764787671,1.606054109,133,10
E2892,Engineering,55,79,6.376348079,-1,14,9,15,4,3.118074114,2.033526596,134,23
E2893,Operations,57,57,12.63094002,1,10,9,20,12,1.393887727,1.467250239,114,19
E2894,Operations,56,72,8.326284295,-1,17,2,15,8,2.037252929,1.608357576,128,19
E2895,Marketing,49,64,9.886841611,0,3,8,15,9,1.010394051,1.37781007,113,11
E2896,Support,45,71,9.430779074,0,3,5,18,1,0.766960928,1.725662088,116,8
E2897,Sales,54,71,9.238724618,0,6,9,20,12,1.465026218,1.95336829,125,15
E2898,Finance,50,75,10.18670301,0,7,4,23,10,0.983310274,2.056012391,125,11
E2899,Engineering,40,67,8.010337427,-1,7,2,24,3,0.998852715,2.663607239,107,9
E2900,Operations,35,85,6.723962227,-1,15,5,14,9,2.589344615,1.812541231,120,20
E2901,Engineering,53,67,10.11651632,0,10,4,21,4,1.259387347,1.889081021,120,14
E2902,Marketing,30,71,8.806766513,0,7,1,22,10,0.815763278,2.243349015,101,8
E2903,Finance,38,65,6.163115874,-1,12,6,18,3,2.512872934,2.512872934,103,18
E2904,Operations,52,84,11.8428178,1,8,5,16,7,1.012238918,1.245832515,136,13
E2905,Engineering,50,70,9.950968718,0,8,3,15,2,1.004477347,1.369741836,120,11
E2906,Sales,46,77,6.739959372,-1,9,4,16,7,1.67959538,2.067194313,123,13
E2907,Support,44,65,9.286843271,0,7,3,12,9,0.97211552,1.166538625,109,10
E2908,Marketing,46,79,9.566352746,0,4,3,17,7,0.662480249,1.608880605,125,7
E2909,Finance,46,78,6.907650613,-1,13,2,24,6,1.896897161,3.035035458,124,15
E2910,Marketing,52,68,19.48725185,3,8,6,19,1,0.683351779,0.927405986,120,14
E2911,Sales,45,73,9.97663447,0,8,8,22,3,1.457641688,2.004257321,118,16
E2912,Finance,29,94,9.340241807,0,3,3,18,4,0.580257223,1.74077167,123,6
E2913,Marketing,45,73,17.31064612,2,8,6,19,9,0.764582523,1.037647709,118,14
E2914,HR,56,62,11.36975685,0,8,5,18,7,1.050950327,1.455161991,118,13
E2915,Sales,50,84,13.62623324,1,5,4,24,5,0.615332728,1.640887275,134,9
E2916,Sales,53,92,10.28289607,0,8,6,19,7,1.240816179,1.683964815,145,14
E2917,Sales,59,67,10.19270309,0,9,7,23,4,1.429502763,2.054910222,126,16
E2918,HR,60,73,7.434093808,-1,10,4,22,8,1.659929367,2.608460434,133,14
E2919,HR,48,69,12.00665828,1,11,9,25,5,1.53767398,1.922092475,117,20
E2920,Engineering,55,73,15.54608112,2,7,4,15,6,0.664809988,0.906559075,128,11
E2921,Operations,62,67,14.73131037,2,12,7,10,10,1.207782413,0.635674954,129,19
E2922,Support,42,74,6.368235451,-1,8,4,22,10,1.628612451,2.985789494,116,12
E2923,Marketing,47,65,15.57868357,2,7,3,22,7,0.603184201,1.327005242,112,10
E2924,Engineering,48,57,7.517871802,-1,10,1,23,5,1.29140239,2.700204997,105,11
E2925,Marketing,54,66,7.178131022,-1,8,5,20,5,1.589605249,2.445546537,120,13
E2926,Support,57,61,7.342410533,-1,12,2,18,5,1.678172028,2.15764975,118,14
E2927,Operations,53,71,8.826921016,0,2,0,25,9,0.203522548,2.544031845,124,2
E2928,HR,50,62,4.201975799,-2,3,6,17,12,1.730111855,3.26798906,112,9
E2929,Operations,59,84,10.15823255,0,11,5,15,1,1.433918851,1.344298923,143,16
E2930,HR,46,63,9.221323156,0,6,5,12,11,1.076181609,1.174016301,109,11
E2931,Support,48,64,10.12455472,0,12,2,20,11,1.258477337,1.797824768,112,14
E2932,Operations,51,79,8.512001715,-1,5,7,20,4,1.261564112,2.102606854,130,12
E2933,Engineering,53,73,5.224015041,-2,11,3,16,8,2.249351891,2.570687875,126,14
E2934,Finance,56,65,9.218726839,0,8,3,21,4,1.076455039,2.055050529,121,11
E2935,Engineering,55,61,13.6612122,1,8,8,23,5,1.091314946,1.568765235,116,16
E2936,Marketing,42,58,6.969483688,-1,8,1,16,4,1.129307789,2.007658291,100,9
E2937,Engineering,50,79,7.368124346,-1,10,3,22,8,1.5535142,2.629024031,129,13
E2938,Support,56,68,11.36463701,0,8,5,18,5,1.051385494,1.455764531,124,13
E2939,Sales,51,77,6.285928598,-1,5,3,23,6,1.098006917,3.156769887,128,8
E2940,Marketing,51,77,10.67743563,0,10,6,19,9,1.370163836,1.627069555,128,16
E2941,Operations,44,59,11.33212431,0,6,6,21,8,0.973068362,1.702869633,103,12
E2942,Marketing,47,58,8.31093016,-1,9,8,18,3,1.825811139,1.933211794,105,17
E2943,Finance,42,77,7.750754042,-1,5,3,16,10,0.914206931,1.828413863,119,8
E2944,HR,43,70,5.77285534,-1,7,8,21,1,2.214723222,3.10061251,113,15
E2945,Operations,55,76,7.626814888,-1,6,1,16,11,0.811423462,1.854682198,131,7
E2946,Marketing,44,69,11.7033037,1,9,5,23,6,1.102075518,1.810552637,113,14
E2947,Operations,55,81,12.51476644,1,10,3,16,10,0.961910815,1.183890234,136,13
E2948,Operations,49,69,10.19101829,0,5,3,25,2,0.714858987,2.233934336,118,8
E2949,Operations,63,65,8.156641221,-1,11,4,19,12,1.638155262,2.074996665,128,15
E2950,HR,53,63,10.21992953,0,3,6,20,6,0.802144075,1.782542389,116,9
E2951,Support,47,65,7.545029245,-1,6,3,21,8,1.053243909,2.45756912,112,9
E2952,Engineering,41,51,10.5372844,0,12,7,25,1,1.646834674,2.166887729,92,19
E2953,Operations,49,76,12.24058629,1,3,12,18,4,1.132880348,1.359456417,125,15
E2954,Sales,47,69,8.603936168,0,10,4,16,8,1.457735636,1.665983584,116,14
E2955,Support,46,67,7.590712488,-1,9,8,21,10,1.978881265,2.444500387,113,17
E2956,Finance,53,68,8.536846936,0,7,5,22,1,1.258277508,2.306842099,121,12
E2957,HR,52,80,13.26253332,1,9,1,16,6,0.701137713,1.121820341,132,10
E2958,Marketing,54,76,18.37398986,3,14,2,13,2,0.825849508,0.671002726,130,16
E2959,HR,46,72,11.94575071,1,8,7,23,11,1.158681357,1.776644747,118,15
E2960,Marketing,66,73,9.780528606,0,3,2,19,2,0.46379915,1.762436769,139,5
E2961,HR,56,63,7.079470096,-1,11,1,13,2,1.485245921,1.609016414,119,12
E2962,Marketing,38,71,6.893296518,-1,11,4,15,5,1.900346701,1.900346701,109,15
E2963,Operations,54,77,11.28296201,0,8,4,19,3,0.976963047,1.546858158,131,12
E2964,Engineering,38,75,7.660594669,-1,5,7,23,3,1.385586147,2.655706782,113,12
E2965,Marketing,38,69,13.06745228,1,6,6,25,7,0.853032927,1.777151932,107,12
E2966,Marketing,48,74,8.190063774,-1,9,8,19,3,1.849823942,2.067450288,122,17
E2967,Sales,62,72,14.26919198,1,8,4,33,4,0.785896203,2.161214559,134,12
E2968,Marketing,51,73,8.772016625,0,10,6,17,7,1.637328365,1.739661387,124,16
E2969,Sales,51,66,13.40032199,1,3,1,15,12,0.277771567,1.041643375,117,4
E2970,Finance,57,78,12.01905378,1,6,1,22,2,0.537673484,1.689830948,135,7
E2971,Operations,46,71,12.5408004,1,14,4,16,3,1.329315806,1.18161405,117,18
E2972,Sales,57,68,9.794399431,0,12,6,17,8,1.6675314,1.574890767,125,18
E2973,Engineering,55,75,8.007331387,-1,9,6,23,10,1.665310108,2.553475498,130,15
E2974,Support,42,84,13.02851502,1,11,5,20,8,1.140534117,1.425667647,126,16
E2975,Operations,46,81,15.37942386,2,9,2,24,11,0.671574293,1.465253003,127,11
E2976,Sales,55,78,6.99288325,-1,2,6,24,3,1.000890386,3.002671158,133,8
E2977,Operations,49,77,11.42664727,0,12,7,17,7,1.528972343,1.368027886,126,19
E2978,Operations,48,69,11.41526208,0,5,5,24,12,0.805460242,1.933104581,117,10
E2979,Operations,40,72,10.49740791,0,8,1,19,3,0.782785135,1.652546395,112,9
E2980,Finance,53,64,14.29338391,1,9,6,29,5,0.980816285,1.896244819,117,15
E2981,Engineering,66,79,7.673346367,-1,9,1,22,3,1.152957529,2.536506565,145,10
E2982,HR,44,66,13.29509587,1,12,7,22,5,1.329127148,1.538989329,110,19
E2983,HR,54,66,9.167928597,0,4,4,17,2,0.786787586,1.671923621,120,8
E2984,Sales,38,67,2.990609967,-2,5,5,13,12,2.50588258,3.257647354,105,10
E2985,Operations,65,74,5.627644086,-1,7,2,22,11,1.357948599,3.319429908,139,9
E2986,Sales,61,70,10.10706989,0,7,7,20,10,1.260458442,1.800654917,131,14
E2987,Finance,41,69,13.66024683,1,8,10,15,3,1.22781016,1.023175133,110,18
E2988,Finance,49,80,13.24395902,1,10,7,22,11,1.19348841,1.544514413,129,17
E2989,Marketing,54,65,10.31611348,0,15,3,18,9,1.590652129,1.590652129,119,18
E2990,Finance,46,64,6.564111835,-1,12,6,18,1,2.3796581,2.3796581,110,18
E2991,Marketing,47,74,6.377204365,-1,9,9,15,4,2.439948673,2.033290561,121,18
E2992,Engineering,56,51,11.26159757,0,10,7,28,12,1.386442501,2.283552355,107,17
E2993,Sales,52,72,9.873178556,0,11,3,20,2,1.287571976,1.839388537,124,14
E2994,Support,48,54,12.91288297,1,6,5,20,2,0.790634121,1.437516584,102,11
E2995,Engineering,48,71,9.003780248,0,10,9,16,9,1.899282024,1.599395389,119,19
E2996,Finance,52,63,7.684133442,-1,3,9,24,5,1.381830447,2.763660895,115,12
E2997,Engineering,64,78,9.165389608,0,9,7,23,8,1.573968202,2.26257929,142,16
E2998,Engineering,54,78,9.960745494,0,5,4,18,5,0.821112032,1.642224063,132,9
E2999,Engineering,52,57,3.901785308,-2,9,5,16,5,2.856102241,3.264116846,109,14
E3000,Finance,45,64,11.41879224,0,8,2,23,7,0.805231282,1.85203195,109,10
E3001,Support,43,70,10.42810309,0,11,9,32,1,1.750071718,2.800114748,113,20
E3002,Operations,53,65,12.84109496,1,7,3,21,12,0.722486193,1.517221004,118,10
E3003,Engineering,40,67,12.34001099,1,11,2,16,7,0.974511941,1.199399312,107,13
E3004,Marketing,60,64,13.24987945,1,8,3,16,4,0.771936355,1.122816516,124,11
E3005,Finance,54,72,15.04209494,2,6,5,19,6,0.685695979,1.184383965,126,11
E3006,Engineering,50,66,10.41867788,0,8,2,17,2,0.875758131,1.488788822,116,10
E3007,Support,47,67,3.380053427,-2,13,4,25,11,3.881231196,5.707692936,114,17
E3008,Operations,51,64,12.58372462,1,8,2,23,11,0.736175112,1.693202759,115,10
E3009,Finance,40,77,13.59742033,1,7,2,13,12,0.616547294,0.890568313,117,9
E3010,HR,54,66,9.317766361,0,5,4,21,2,0.872281818,2.035324242,120,9
E3011,Operations,44,76,3.950357277,-2,7,8,19,8,3.030084327,3.838106814,120,15
E3012,Marketing,43,71,13.1195632,1,7,3,30,12,0.708237207,2.12471162,114,10
E3013,Engineering,46,68,9.941964687,0,10,6,15,9,1.462260248,1.370868983,114,16
E3014,Support,50,70,5.996214018,-1,3,9,19,11,1.715213395,2.715754543,120,12
E3015,HR,52,70,9.197613618,0,5,4,19,8,0.882559424,1.863181006,122,9
E3016,Support,61,66,9.985264582,0,7,2,21,10,0.819279311,1.911651726,127,9
E3017,HR,47,90,9.19661457,0,6,6,8,5,1.176861194,0.78457413,137,12
E3018,Finance,56,80,8.483478551,-1,9,6,19,12,1.581698099,2.003484259,136,15
E3019,HR,36,69,12.85583295,1,9,3,11,1,0.86606125,0.793889479,105,12
E3020,Marketing,53,69,14.05343652,1,9,8,20,3,1.129310239,1.328600281,122,17
E3021,Marketing,47,62,15.79579418,2,7,7,14,12,0.833542007,0.833542007,109,14
E3022,Sales,48,63,6.988822606,-1,8,4,16,2,1.502098694,2.002798258,111,12
E3023,Marketing,46,85,13.90234242,1,11,3,22,4,0.939449625,1.476277982,131,14
E3024,Operations,51,63,10.57269363,0,7,8,18,9,1.296154593,1.555385511,114,15
E3025,HR,50,67,11.12737003,0,12,4,21,9,1.319329744,1.731620289,117,16
E3026,Marketing,43,70,13.64322606,1,6,8,27,9,0.956073473,1.843855984,113,14
E3027,Finance,47,80,9.850314675,0,2,7,11,9,0.829469031,1.013795482,127,9
E3028,Support,54,87,9.452433999,0,6,3,12,12,0.861043466,1.148057955,141,9
E3029,Support,49,77,7.919403576,-1,10,6,15,3,1.793841916,1.681726796,126,16
E3030,Sales,45,62,6.50011399,-1,11,6,16,3,2.266632217,2.13330091,107,17
E3031,Support,53,67,8.102736913,-1,8,4,23,7,1.318284832,2.526712594,120,12
E3032,HR,54,69,10.51329981,0,3,8,17,8,0.955416794,1.476553228,123,11
E3033,Sales,54,66,9.849124732,0,4,7,14,6,1.013906676,1.290426679,120,11
E3034,HR,49,70,8.858146865,0,9,3,27,2,1.217267318,2.738851467,119,12
E3035,Finance,40,67,8.950726983,0,3,5,21,10,0.80396136,2.11039857,107,8
E3036,Sales,40,62,13.15403121,1,5,4,20,10,0.635861252,1.413025004,102,9
E3037,Engineering,53,74,10.52690303,0,8,7,15,5,1.301303564,1.301303564,127,15
E3038,Operations,54,55,7.019856602,-1,7,6,23,8,1.620976614,2.867881702,109,13
E3039,Operations,46,67,10.17370241,0,10,3,14,7,1.163446056,1.252941906,113,13
E3040,HR,47,67,11.84828893,1,12,1,14,12,1.011807882,1.089639257,114,13
E3041,Support,60,68,12.86933351,1,5,5,25,11,0.72101518,1.80253795,128,10
E3042,Engineering,50,72,11.69241888,1,8,5,13,7,1.024233452,1.024233452,122,13
E3043,Sales,49,75,12.54560038,1,7,5,25,7,0.885896502,1.845617713,124,12
E3044,Engineering,50,61,11.51817861,0,12,6,16,7,1.437908866,1.278141214,111,18
E3045,Engineering,45,71,3.979358491,-2,5,2,23,4,1.405803581,4.61906891,116,7
E3046,Support,49,92,9.519152457,0,14,5,15,3,1.806229169,1.425970397,141,19
E3047,Sales,49,77,9.729224655,0,9,1,17,3,0.932033798,1.584457456,126,10
E3048,Finance,58,82,16.11809006,2,8,3,14,10,0.642595053,0.81784825,140,11
E3049,Support,50,73,12.27813146,1,13,5,15,7,1.355612426,1.129677022,123,18
E3050,Engineering,54,58,9.127158523,0,10,3,20,1,1.283676953,1.974887621,112,13
E3051,Engineering,49,61,7.681887217,-1,11,7,17,2,2.073281943,1.958099613,110,18
E3052,Finance,49,73,8.967873488,0,7,4,24,9,1.103545306,2.407735213,122,11
E3053,Engineering,44,64,7.574818768,-1,5,4,20,3,1.049584865,2.332410811,108,9
E3054,Engineering,48,70,16.5395307,2,8,5,18,12,0.741182887,1.026253228,118,13
E3055,Engineering,51,64,9.954194488,0,12,6,29,9,1.643206173,2.647387723,115,18
E3056,Operations,49,76,12.4744903,1,7,2,18,12,0.66792879,1.33585758,125,9
E3057,Support,49,65,11.54600858,1,9,3,17,4,0.956479499,1.355012624,114,12
E3058,Marketing,51,77,11.97200307,1,9,4,15,7,1.002158258,1.156336451,128,13
E3059,Support,60,63,7.358061886,-1,6,8,16,4,1.675029474,1.914319398,123,14
E3060,Finance,41,61,14.01182077,1,3,7,22,3,0.666141713,1.465511768,102,10
E3061,Engineering,43,68,9.735038089,0,8,8,15,4,1.490446505,1.397293598,111,16
E3062,Support,50,69,14.50120346,1,10,5,22,4,0.967666803,1.419244644,119,15
E3063,Operations,38,56,11.2770058,0,10,7,14,6,1.384702449,1.140343193,94,17
E3064,Finance,53,69,15.26194038,2,9,4,19,12,0.799412598,1.168372258,122,13
E3065,HR,55,92,11.80095311,1,7,4,19,11,0.859311014,1.484264479,147,11
E3066,Support,48,70,9.443165918,0,10,8,19,3,1.723615247,1.819371649,118,18
E3067,HR,55,74,14.21687363,1,6,8,23,8,0.920031298,1.51147999,129,14
E3068,Engineering,55,70,10.4149309,0,8,5,17,12,1.138859282,1.489277522,125,13
E3069,Operations,50,92,11.61425132,1,11,4,20,1,1.189131216,1.585508287,142,15
E3070,Operations,54,77,10.267757,0,11,8,18,7,1.686227348,1.59747854,131,19
E3071,Support,42,75,8.37719138,-1,12,4,20,9,1.706267831,2.132834789,117,16
E3072,Finance,45,64,9.521731896,0,9,6,22,7,1.425620815,2.090910529,109,15
E3073,Finance,44,67,12.13495213,1,6,4,16,8,0.76132748,1.218123967,111,10
E3074,Operations,59,79,12.91649833,1,7,6,17,7,0.934143036,1.221571663,138,13
E3075,Finance,49,80,3.941092988,-2,10,6,20,11,3.238149947,4.047687434,129,16
E3076,Operations,52,89,10.96094382,0,11,6,21,1,1.421292522,1.755714291,141,17
E3077,Support,47,81,9.766297659,0,8,8,23,4,1.486119045,2.136296128,128,16
E3078,Marketing,52,55,5.889565206,-1,5,4,24,10,1.306323365,3.483528972,107,9
E3079,Operations,49,59,12.57253335,1,8,5,25,12,0.957816766,1.841955319,108,13
E3080,HR,38,78,15.41992675,2,11,3,12,8,0.852622561,0.730819338,116,14
E3081,Finance,48,74,14.44501668,1,8,6,23,6,0.906441235,1.489153458,122,14
E3082,Operations,47,63,3.000135689,-2,8,6,22,7,3.499881276,5.499813434,110,14
E3083,Operations,50,64,10.97358866,0,10,9,23,10,1.58682585,1.92089445,114,19
E3084,Support,55,61,8.051008826,-1,8,3,11,12,1.215334137,1.215334137,116,11
E3085,Finance,41,69,8.655309707,0,5,3,16,5,0.828559647,1.657119293,110,8
E3086,Marketing,39,72,9.243459473,0,6,9,20,12,1.464349036,1.952465381,111,15
E3087,Support,63,83,3.332077206,-2,13,5,23,2,4.155050601,5.309231323,146,18
E3088,Marketing,63,67,3.825350424,-2,8,3,21,9,2.279627184,4.352015533,130,11
E3089,Support,62,61,10.25558624,0,6,7,18,5,1.154982044,1.599205906,123,13
E3090,Finance,44,69,10.74310685,0,7,5,26,3,1.02187608,2.214064841,113,12
E3091,Sales,43,56,9.413878823,0,5,3,26,5,0.768205597,2.496668191,99,8
E3092,Finance,45,85,6.253833732,-1,13,9,17,9,3.032879001,2.343588319,130,22
E3093,Finance,50,72,8.787810012,0,7,4,22,9,1.123846906,2.247693812,122,11
E3094,Marketing,63,76,14.33632036,1,9,2,22,8,0.71725158,1.434503159,139,11
E3095,Marketing,35,67,8.911712285,0,10,7,15,5,1.715142602,1.513361119,102,17
E3096,Finance,57,80,8.491611702,-1,4,4,28,2,0.842849481,2.949973185,137,8
E3097,Finance,56,90,13.71060754,1,3,6,25,7,0.61180342,1.699453943,146,9
E3098,Finance,50,68,9.352761683,0,11,1,19,3,1.159111005,1.835259091,118,12
E3099,Marketing,52,66,12.04129928,1,10,3,24,10,0.996833193,1.840307433,118,13
E3100,Finance,52,66,11.38255924,0,10,8,21,7,1.453657492,1.69593374,118,18
E3101,Finance,49,60,7.323257705,-1,14,7,23,9,2.523050559,2.763341088,109,21
E3102,Engineering,55,64,7.027884141,-1,6,3,19,10,1.121092413,2.366750649,119,9
E3103,Sales,67,81,5.956270383,-1,9,0,16,8,1.293796748,2.300083108,148,9
E3104,HR,36,80,6.970922728,-1,5,3,16,4,1.003647918,2.007295836,116,8
E3105,Sales,60,63,12.48097349,1,5,10,17,6,1.112679289,1.261036528,123,15
E3106,Engineering,47,67,7.534601102,-1,7,0,26,2,0.820190647,3.046422403,114,7
E3107,HR,56,60,9.586271822,0,7,6,33,8,1.228005498,3.117244725,116,13
E3108,Support,42,73,9.155032109,0,9,2,22,4,1.083206816,2.166413633,115,11
E3109,Finance,55,75,11.13878879,0,11,3,20,5,1.153327588,1.64761084,130,14
E3110,Engineering,45,69,5.905806873,-1,2,9,12,9,1.592862384,1.737668055,114,11
E3111,Support,38,84,13.2941552,1,10,1,18,6,0.769545304,1.259255951,122,11
E3112,Finance,48,59,14.30860305,1,9,5,26,10,0.914518454,1.698391415,107,14
E3113,Marketing,62,72,9.924538899,0,6,9,31,8,1.373055663,2.83764837,134,15
E3114,Operations,48,69,3.281140251,-2,7,2,22,7,2.102243672,5.138817864,117,9
E3115,Engineering,48,60,7.422717016,-1,11,3,33,10,1.662171479,3.917975629,108,14
E3116,Marketing,38,68,10.94803176,0,12,3,21,12,1.255436904,1.757611666,106,15
E3117,Engineering,48,64,11.11643928,0,19,4,19,12,1.898247453,1.568117461,112,23
E3118,Engineering,45,88,9.226667101,0,4,8,21,3,1.173402819,2.053454932,133,12
E3119,Marketing,36,66,13.30184985,1,11,5,18,7,1.118736399,1.258578449,102,16
E3120,HR,46,81,8.271281429,-1,12,4,16,2,1.725759284,1.725759284,127,16
E3121,Sales,45,59,12.95232034,1,7,6,12,3,0.931744662,0.860071996,104,13
E3122,Finance,47,76,10.00301333,0,10,8,16,2,1.635915495,1.454147107,123,18
E3123,Engineering,31,68,8.301745048,-1,7,8,17,9,1.612600638,1.827614056,99,15
E3124,Finance,56,67,12.19470875,1,5,4,17,12,0.6820916,1.288395245,123,9
E3125,Operations,48,75,9.868260128,0,10,8,13,12,1.656198857,1.196143619,123,18
E3126,Marketing,59,71,12.66242391,1,8,5,23,9,0.951514906,1.683449449,130,13
E3127,Finance,51,73,18.71911476,3,8,2,27,3,0.507122156,1.369229822,124,10
E3128,Marketing,45,84,7.19803411,-1,17,7,22,10,2.927531122,2.683570196,129,24
E3129,Finance,49,71,12.64237411,1,8,2,24,8,0.733010246,1.75922459,120,10
E3130,Sales,53,64,11.91385417,1,8,7,23,12,1.161543239,1.781032967,117,15
E3131,Sales,56,64,15.33793111,2,5,7,28,2,0.734487122,1.713803285,120,12
E3132,Sales,55,61,12.74244312,1,9,6,15,2,1.091508975,1.091508975,116,15
E3133,Sales,47,67,14.71881326,2,9,7,20,3,1.017888548,1.272360684,114,16
E3134,Sales,49,64,7.048660134,-1,9,10,23,11,2.360641359,2.857618488,113,19
E3135,Sales,46,84,6.173258211,-1,6,4,13,8,1.394066644,1.812286637,130,10
E3136,Marketing,51,70,7.178131989,-1,10,3,22,2,1.589605061,2.690100873,121,13
E3137,Engineering,41,70,9.529465351,0,10,5,22,10,1.424573756,2.089374842,111,15
E3138,Finance,53,70,14.14754236,1,6,6,19,9,0.79220772,1.254328891,123,12
E3139,Sales,44,85,14.81723887,2,11,4,22,5,0.948332394,1.390887511,129,15
E3140,Marketing,53,66,8.905529942,0,8,2,20,3,1.009537103,2.019074206,119,10
E3141,Marketing,47,75,9.663316691,0,5,8,22,8,1.219132881,2.063147953,122,13
E3142,Marketing,58,54,6.48411683,-1,7,5,19,10,1.603395601,2.538709701,112,12
E3143,Engineering,46,68,10.21830342,0,6,7,20,7,1.158820502,1.782800772,114,13
E3144,Finance,44,55,9.405369495,0,8,7,20,12,1.441563417,1.922084555,99,15
E3145,Engineering,57,67,9.414015128,0,10,4,12,2,1.344342199,1.152293314,124,14
E3146,HR,46,62,13.54218083,1,8,5,18,8,0.8939512,1.237778584,108,13
E3147,Support,48,68,11.21442798,0,7,3,21,12,0.818703915,1.719278221,116,10
E3148,Marketing,52,81,6.077710718,-1,6,5,24,3,1.554174851,3.390926947,133,11
E3149,HR,53,77,2.349395374,-3,4,4,30,4,2.388490789,8.95684046,130,8
E3150,Operations,57,68,11.65591943,1,7,3,25,5,0.790144094,1.975360236,125,10
E3151,Sales,32,90,10.6971189,0,7,4,27,1,0.940402512,2.308260712,122,11
E3152,Support,59,76,11.13295184,0,8,4,17,8,0.989042086,1.401142955,135,12
E3153,Sales,66,77,10.69750951,0,5,5,12,2,0.854882827,1.025859392,143,10
E3154,Engineering,46,68,6.566323022,-1,9,7,20,6,2.114633482,2.643291853,114,16
E3155,Support,51,85,9.430678422,0,4,6,21,5,0.958710411,2.013291864,136,10
E3156,Finance,42,62,9.083060066,0,3,3,24,12,0.595057449,2.380229796,104,6
E3157,HR,51,72,9.756203836,0,7,5,29,12,1.115635236,2.696118486,123,12
E3158,Finance,50,65,12.63507871,1,3,0,24,11,0.220020732,1.760165857,115,3
E3159,Engineering,43,69,8.267814405,-1,7,7,25,10,1.510604268,2.697507622,112,14
E3160,Sales,47,68,6.532007339,-1,11,7,18,9,2.389801177,2.389801177,115,18
E3161,Support,58,70,14.0198419,1,5,6,17,2,0.732364566,1.131836148,128,11
E3162,Finance,46,77,7.809214917,-1,10,6,24,1,1.816279901,2.724419852,123,16
E3163,Finance,55,61,13.45730166,1,5,6,14,3,0.760861207,0.968368809,116,11
E3164,Sales,49,78,16.4543851,2,11,9,23,2,1.14584386,1.317720439,127,20
E3165,Support,53,78,14.5212911,1,8,6,13,4,0.90198682,0.83755919,131,14
E3166,HR,42,77,11.99348263,1,7,8,26,7,1.154424909,2.001003175,119,15
E3167,Sales,45,66,9.40545298,0,4,1,24,5,0.480517284,2.306482961,111,5
E3168,Finance,65,75,12.73924282,1,6,9,15,4,1.091763221,1.091763221,140,15
E3169,HR,45,73,9.931270349,0,3,5,22,1,0.731845407,2.01257487,118,8
E3170,HR,46,66,14.24627739,1,8,7,14,12,0.98384672,0.918256939,112,15
E3171,Sales,45,72,11.91560823,1,7,5,24,6,0.929108392,1.858216784,117,12
E3172,Finance,52,70,11.13497308,0,5,10,18,8,1.236096685,1.483316022,122,15
E3173,Engineering,48,65,10.14777663,0,5,8,18,9,1.166151819,1.61467175,113,13
E3174,Finance,50,71,8.517519193,-1,10,5,19,5,1.576040951,1.996318538,121,15
E3175,Marketing,64,63,9.99322256,0,8,7,13,12,1.36447706,1.182546785,127,15
E3176,Support,39,81,10.87847251,0,15,7,26,9,1.852089987,2.188833621,120,22
E3177,Operations,49,66,9.229164112,0,3,6,23,1,0.879837287,2.248473067,115,9
E3178,Engineering,58,82,10.89404082,0,7,1,23,3,0.672605729,1.933741472,140,8
E3179,HR,43,67,12.9568203,1,8,7,30,10,1.074743364,2.149486728,110,15
E3180,Engineering,61,65,10.83271191,0,12,1,19,7,1.098649245,1.605718127,126,13
E3181,Support,50,78,8.396771682,-1,6,3,11,6,0.957775745,1.1706148,128,9
E3182,HR,55,69,1.733053982,-3,8,7,24,9,5.488365798,8.781385276,124,15
E3183,Support,44,80,13.64127931,1,10,7,17,5,1.161100724,1.161100724,124,17
E3184,HR,38,78,9.668267818,0,6,7,22,12,1.218567083,2.062190449,116,13
E3185,Engineering,57,67,10.60139031,0,7,3,16,10,0.861965655,1.379145048,124,10
E3186,HR,41,64,11.63497842,1,12,6,17,7,1.4246166,1.345471233,105,18
E3187,HR,57,75,11.63574429,1,10,5,23,4,1.187108543,1.820233099,132,15
E3188,Marketing,54,66,12.27334547,1,13,6,24,10,1.431440178,1.808134962,120,19
E3189,Finance,50,74,13.02649546,1,9,4,25,10,0.926817396,1.782341147,124,13
E3190,Finance,49,66,12.26662051,1,7,4,23,7,0.829148613,1.733674373,115,11
E3191,Operations,57,57,0.648903048,-3,4,4,21,3,4.85171036,12.73573969,114,8
E3192,Operations,36,63,11.17893928,0,6,5,26,2,0.903198525,2.134832878,99,11
E3193,Marketing,36,67,10.76498641,0,12,5,18,2,1.444965545,1.529963518,103,17
E3194,Operations,53,74,9.241596982,0,8,7,16,1,1.464615335,1.562256358,127,15
E3195,Support,44,73,11.43859259,0,5,8,27,10,1.045134319,2.170663586,117,13
E3196,Engineering,42,68,10.06075347,0,10,1,25,2,0.994507294,2.260243849,110,11
E3197,Sales,56,78,8.296126506,-1,9,5,19,3,1.506003602,2.043862031,134,14
E3198,Support,46,66,13.71024336,1,11,5,23,5,1.087677451,1.563536336,112,16
E3199,Sales,59,64,11.0433641,0,13,5,11,6,1.494599005,0.913366058,123,18
E3200,Sales,64,73,10.51748241,0,7,5,20,3,1.041894363,1.736490605,137,12
E3201,Marketing,59,58,3.74937232,-2,6,5,24,9,2.31609553,5.053299338,117,11
E3202,Support,59,76,16.38589666,2,11,2,21,2,0.747732501,1.207875579,135,13
E3203,Marketing,46,68,4.407025169,-2,11,6,15,4,3.144057863,2.774168703,114,17
E3204,HR,46,70,11.57261157,1,8,6,23,5,1.113531578,1.829373306,116,14
E3205,Sales,57,67,12.13891908,1,4,3,16,11,0.532768332,1.217756187,124,7
E3206,Engineering,36,74,14.93325429,2,10,3,22,1,0.815903629,1.380759988,110,13
E3207,Operations,46,67,7.115005817,-1,11,4,31,1,1.848427511,3.820083522,113,15
E3208,Engineering,53,64,7.573684391,-1,8,2,16,4,1.166359705,1.866175528,117,10
E3209,Operations,50,66,12.4011298,1,5,5,20,5,0.746205742,1.492411483,116,10
E3210,Sales,47,61,11.95278699,1,1,7,24,9,0.617627697,1.852883091,108,8
E3211,Sales,49,57,15.10539708,2,9,5,8,11,0.869273817,0.496727896,106,14
E3212,Sales,53,64,13.26223403,1,8,5,12,5,0.911498155,0.841382912,117,13
E3213,Marketing,47,54,8.984784689,0,9,7,23,4,1.602438159,2.303504854,101,16
E3214,Support,46,69,9.666833553,0,7,3,15,3,0.937485332,1.406227999,115,10
E3215,Operations,50,71,11.56906458,1,8,4,21,2,0.954724986,1.670768725,121,12
E3216,Support,48,91,5.414632582,-2,2,4,19,10,0.935361445,2.961977908,139,6
E3217,Marketing,44,60,11.68326436,1,10,6,22,9,1.261504889,1.734569222,104,16
E3218,Marketing,49,55,11.9002813,1,8,6,18,2,1.085247653,1.395318411,104,14
E3219,Finance,44,70,7.569833101,-1,2,7,14,2,1.050195482,1.633637416,114,9
E3220,Engineering,49,86,9.361045266,0,8,5,19,8,1.254699663,1.833791815,135,13
E3221,Engineering,59,65,4.053950207,-2,11,2,24,11,2.572245366,4.748760676,124,13
E3222,HR,43,60,12.78667406,1,8,5,22,2,0.942939533,1.595743826,103,13
E3223,Marketing,60,74,11.25386631,0,7,2,26,9,0.734462069,2.12177931,134,9
E3224,Operations,54,79,6.0802525,-1,8,8,21,11,2.259806412,2.965995916,133,16
E3225,Finance,42,67,6.819823584,-1,12,7,17,12,2.429722333,2.173962087,109,19
E3226,Finance,44,73,8.696209811,0,5,4,17,10,0.928197737,1.753262391,117,9
E3227,Support,50,59,12.54787738,1,8,4,26,1,0.885747609,1.91911982,109,12
E3228,Engineering,52,62,11.51360768,0,10,10,16,1,1.598260111,1.278608089,114,20
E3229,Marketing,50,80,7.53330554,-1,7,6,30,4,1.523442462,3.51563645,130,13
E3230,HR,46,63,8.220176902,-1,7,6,26,4,1.409951256,2.819902511,109,13
E3231,Marketing,54,60,10.15778992,0,10,8,26,9,1.613222702,2.33021057,114,18
E3232,Support,51,62,7.597997517,-1,7,10,19,4,1.977204572,2.209816874,113,17
E3233,Sales,66,68,8.438659602,-1,7,12,30,7,2.012997693,3.178417409,134,19
E3234,Marketing,46,63,12.07560699,1,10,8,24,6,1.376609132,1.835478843,109,18
E3235,Support,48,70,6.3195346,-1,7,8,19,5,2.049310621,2.595793454,118,15
E3236,Sales,53,72,9.572898601,0,4,3,26,8,0.662070097,2.459117502,125,7
E3237,Sales,45,74,9.349704729,0,8,8,19,12,1.545937823,1.835801165,119,16
E3238,HR,52,64,9.871433037,0,7,1,22,12,0.735873548,2.023652257,116,8
E3239,Operations,48,68,10.79263338,0,9,3,17,4,1.01758442,1.441577929,116,12
E3240,Engineering,61,72,11.84376777,1,3,5,14,8,0.622870184,1.090022823,133,8
E3241,Marketing,50,74,12.35265652,1,9,6,16,3,1.123371966,1.19826343,124,15
E3242,Sales,40,88,8.968169747,0,9,6,24,9,1.504789784,2.407663654,128,15
E3243,Marketing,46,69,9.545706476,0,13,4,23,2,1.612030454,2.180982379,115,17
E3244,Operations,35,66,11.05286899,0,6,3,20,1,0.746710182,1.659355961,101,9
E3245,Engineering,52,66,10.54042228,0,6,3,24,5,0.779867476,2.079646603,118,9
E3246,Operations,48,72,11.71211931,1,8,4,21,2,0.943981071,1.651966874,120,12
E3247,Engineering,54,72,11.34907737,0,8,4,22,4,0.971732514,1.781509609,126,12
E3248,Finance,55,73,7.528381707,-1,9,8,18,9,1.993344175,2.110599715,128,17
E3249,Engineering,42,78,15.62334029,2,10,1,13,2,0.661720196,0.782032959,120,11
E3250,HR,50,72,10.0110301,0,7,2,28,2,0.81736222,2.542904683,122,9
E3251,Operations,51,73,12.09911172,1,10,6,19,6,1.22145687,1.450480033,124,16
E3252,Sales,54,77,11.83176279,1,9,1,24,5,0.779316152,1.870358765,131,10
E3253,Finance,48,82,10.8157763,0,2,7,14,9,0.761693499,1.184856555,130,9
E3254,HR,46,67,10.78700909,0,4,3,17,10,0.59387415,1.442265792,113,7
E3255,Marketing,50,75,12.781999,1,14,6,26,9,1.451168295,1.886518784,125,20
E3256,Operations,42,56,9.375127655,0,10,3,20,2,1.252996631,1.927687125,98,13
E3257,Support,45,71,12.32680799,1,6,3,19,7,0.675330507,1.425697738,116,9
E3258,Support,58,64,11.5072711,0,7,1,21,6,0.639627936,1.679023333,122,8
E3259,Sales,55,85,13.52737168,1,9,5,22,5,0.963698067,1.514382676,140,14
E3260,Engineering,55,65,8.510787977,-1,12,3,17,7,1.577156387,1.787443905,120,15
E3261,Sales,53,72,10.25292459,0,12,3,17,6,1.332986805,1.510718379,125,15
E3262,Support,37,70,7.434249818,-1,5,5,23,12,1.185641902,2.726976376,107,10
E3263,Marketing,49,78,13.32931714,1,7,8,24,8,1.046804942,1.674887907,127,15
E3264,Finance,55,53,7.782223827,-1,13,3,26,11,1.821862015,2.960525775,108,16
E3265,Finance,44,59,10.99614913,0,6,2,16,4,0.666880673,1.333761345,103,8
E3266,Operations,49,73,8.638926968,0,19,5,20,8,2.489903708,2.074919757,122,24
E3267,Finance,51,64,13.42355467,1,6,5,21,9,0.762641405,1.455951773,115,11
E3268,Operations,52,84,9.824406708,0,7,4,14,10,1.016221978,1.293373427,136,11
E3269,Operations,47,74,11.95341971,1,9,7,24,1,1.235195057,1.852792586,121,16
E3270,Operations,63,75,6.748483005,-1,4,5,26,12,1.16151768,3.355495519,138,9
E3271,Support,48,63,8.106388399,-1,9,4,15,3,1.427569244,1.647195281,111,13
E3272,Support,58,67,11.82112438,1,10,4,22,11,1.091947913,1.715918148,125,14
E3273,Engineering,41,77,13.87285781,1,10,4,18,4,0.941312032,1.210258327,118,14
E3274,HR,37,64,11.5782175,1,8,5,17,6,1.033532772,1.351542856,101,13
E3275,Operations,55,76,17.14895445,2,4,2,14,8,0.330597557,0.771394299,131,6
E3276,Operations,41,87,12.37443982,1,11,3,26,12,1.046772814,1.944006654,128,14
E3277,HR,34,67,10.04806044,0,7,7,22,8,1.26719075,1.99129975,101,14
E3278,Sales,36,65,9.037005796,0,10,1,20,10,1.095944371,1.992626128,101,11
E3279,Operations,58,73,15.45120519,2,8,3,22,6,0.668644022,1.337288043,131,11
E3280,Engineering,55,65,12.42234314,1,6,3,24,2,0.670523761,1.788063362,120,9
E3281,Finance,53,63,8.453717557,-1,14,4,16,6,1.904012881,1.692455894,116,18
E3282,Finance,55,62,8.02333866,-1,12,5,21,2,1.884003321,2.32729822,117,17
E3283,Marketing,61,73,8.008783657,-1,10,5,18,1,1.66504165,1.998049979,134,15
E3284,Marketing,47,54,11.53375495,0,11,3,20,8,1.116983701,1.595691002,101,14
E3285,Finance,52,60,5.445553485,-2,6,5,9,1,1.706602858,1.396311429,112,11
E3286,Finance,66,57,8.467175273,-1,6,5,16,12,1.161909406,1.690050045,123,11
E3287,Support,45,72,10.89258104,0,12,6,24,1,1.513548652,2.018064869,117,18
E3288,Engineering,42,68,10.08283608,0,6,7,15,12,1.172984957,1.353444181,110,13
E3289,HR,51,73,8.635019765,0,9,5,23,3,1.453032826,2.387125357,124,14
E3290,Marketing,52,65,12.08447412,1,5,7,22,1,0.917117485,1.681382056,117,12
E3291,Support,50,74,12.06912286,1,11,4,14,6,1.147743438,1.071227209,124,15
E3292,Support,41,78,9.350605595,0,7,3,17,9,0.966127045,1.642415977,119,10
E3293,HR,48,68,8.405719352,-1,9,4,22,6,1.382137773,2.339002385,116,13
E3294,Support,38,81,12.59373071,1,13,6,21,8,1.397703133,1.544829778,119,19
E3295,Engineering,42,71,9.523835071,0,11,2,19,4,1.235291119,1.805425481,113,13
E3296,Finance,45,69,10.0421448,0,5,7,19,5,1.086745394,1.720680207,114,12
E3297,Operations,46,76,12.3485401,1,12,3,16,5,1.123718391,1.19863295,122,15
E3298,HR,45,80,6.699852469,-1,5,7,23,12,1.558471418,2.987070219,125,12
E3299,Finance,50,73,8.445245461,-1,5,6,21,6,1.164607108,2.223340842,123,11
E3300,Finance,44,78,9.217243048,0,5,1,16,9,0.587242564,1.56598017,122,6
E3301,Sales,53,75,15.7214443,2,6,8,15,1,0.837248251,0.897051698,128,14
E3302,HR,65,68,6.242180802,-1,6,4,22,9,1.380799551,3.037759012,133,10
E3303,Support,56,74,10.11934035,0,9,4,13,6,1.169134103,1.169134103,130,13
E3304,Operations,60,77,7.340252837,-1,15,4,23,10,2.278108394,2.757710162,137,19
E3305,HR,54,68,16.92765063,2,10,9,14,8,1.059815388,0.780916601,122,19
E3306,Support,42,68,10.80045098,0,5,5,22,3,0.84742524,1.864335527,110,10
E3307,Finance,50,58,7.140616849,-1,6,4,27,9,1.22840814,3.316701977,108,10
E3308,Operations,50,75,5.06206485,-2,5,8,24,9,2.144483822,3.959047057,125,13
E3309,Support,47,71,11.83602771,1,7,2,18,12,0.701151494,1.402302987,118,9
E3310,Engineering,53,68,10.57935992,0,10,2,25,11,1.036326712,2.159013984,121,12
E3311,Support,50,75,11.90718261,1,10,6,21,7,1.239619868,1.627001077,125,16
E3312,Sales,47,95,6.980264701,-1,4,9,21,2,1.629018646,2.631491659,142,13
E3313,Finance,54,63,15.60484675,2,6,5,15,7,0.662457183,0.903350704,117,11
E3314,Support,54,55,10.245696,0,9,5,19,5,1.244920724,1.689535268,109,14
E3315,Marketing,53,67,11.27320436,0,9,8,23,6,1.38513134,1.874001224,120,17
E3316,Marketing,50,64,11.87176958,1,3,10,15,9,1.009962144,1.165340935,114,13
E3317,Sales,52,77,10.30803519,0,12,4,16,3,1.414923081,1.414923081,129,16
E3318,Engineering,36,72,13.91666194,1,10,5,24,3,1.005586911,1.608939058,108,15
E3319,Finance,46,81,8.410198548,-1,9,6,22,3,1.594015251,2.337889035,127,15
E3320,HR,56,65,13.06696967,1,12,11,18,9,1.63503587,1.27959329,121,23
E3321,Sales,47,75,13.99942571,1,4,4,16,11,0.533353753,1.066707507,122,8
E3322,Engineering,45,80,13.10991748,1,4,4,22,3,0.566977094,1.559187007,125,8
E3323,HR,53,72,14.3030374,1,6,3,20,6,0.588118539,1.306930087,125,9
E3324,Marketing,55,63,7.808935417,-1,7,4,21,11,1.248732052,2.383943009,118,11
E3325,Marketing,53,48,11.48992778,0,12,4,21,4,1.281032227,1.681354798,101,16
E3326,HR,48,74,11.25225993,0,11,5,22,10,1.305881534,1.795587109,122,16
E3327,Sales,57,78,10.22469998,0,4,6,19,5,0.890892408,1.692695576,135,10
E3328,Marketing,50,63,11.88078081,1,7,6,20,12,1.009255587,1.552700904,113,13
E3329,Finance,43,65,13.62105956,1,5,2,20,4,0.478761472,1.367889921,108,7
E3330,Operations,71,70,7.832919417,-1,10,6,16,3,1.811405634,1.811405634,141,16
E3331,Support,51,75,6.378686543,-1,6,2,18,7,1.084203802,2.439458553,126,8
E3332,HR,48,82,9.384956542,0,12,7,20,10,1.829569524,1.925862657,130,19
E3333,HR,57,66,2.546557561,-2,11,2,14,8,3.665526296,3.947489857,123,13
E3334,Marketing,51,67,9.791867865,0,6,4,21,1,0.926623651,1.945909667,118,10
E3335,Sales,41,63,14.28896269,1,15,5,11,5,1.30813322,0.719473271,104,20
E3336,Finance,55,73,5.729614869,-1,8,10,22,10,2.674744447,3.269132102,128,18
E3337,Sales,59,72,8.746942376,0,12,5,18,12,1.744136709,1.846732986,131,17
E3338,Engineering,49,77,6.589857984,-1,12,5,20,7,2.239831106,2.635095418,126,17
E3339,Engineering,39,84,11.19013512,0,7,4,21,2,0.902368997,1.722704448,123,11
E3340,Operations,50,76,11.91050038,1,8,7,21,6,1.161844976,1.626582966,126,15
E3341,Marketing,48,77,10.06427789,0,12,2,21,3,1.265333368,1.898000052,125,14
E3342,Marketing,40,74,7.945465095,-1,8,4,21,1,1.341461833,2.347558207,114,12
E3343,Marketing,49,72,10.57080559,0,7,5,23,10,1.037092872,1.987761338,121,12
E3344,Operations,43,65,13.7117875,1,10,1,22,1,0.747699761,1.495399523,108,11
E3345,Engineering,53,77,12.66904994,1,4,5,15,10,0.658421766,1.09736961,130,9
E3346,Sales,49,68,8.779395664,0,4,4,19,5,0.81804646,1.942860342,117,8
E3347,Operations,55,78,9.027472723,0,7,3,28,10,0.997260255,2.792328713,133,10
E3348,Operations,44,71,8.944843725,0,4,6,22,9,1.005546218,2.21220168,115,10
E3349,Sales,48,77,11.47127923,0,10,4,18,10,1.122579308,1.443316253,125,14
E3350,Marketing,38,71,5.854425114,-1,6,1,23,8,1.021238088,3.355496576,109,7
E3351,Finance,51,78,11.62806619,1,9,3,28,8,0.950264262,2.217283278,129,12
E3352,Sales,43,68,8.375786132,-1,6,6,25,11,1.279892676,2.666443075,111,12
E3353,Engineering,56,60,9.205148588,0,6,6,20,4,1.175877048,1.959795081,116,12
E3354,HR,44,74,7.807965768,-1,10,5,24,4,1.703003894,2.72480623,118,15
E3355,HR,45,72,12.19382731,1,5,5,15,5,0.757930187,1.136895281,117,10
E3356,Support,54,72,8.221826609,-1,7,3,20,3,1.084383867,2.168767734,126,10
E3357,Support,50,58,7.121872384,-1,9,6,23,11,1.846864773,2.831859319,108,15
E3358,Operations,46,78,8.262574686,-1,2,3,21,4,0.539806714,2.267188197,124,5
E3359,HR,57,75,6.753601662,-1,9,6,9,10,1.93458481,1.160750886,132,15
E3360,Finance,51,62,12.58508084,1,5,6,24,5,0.809711781,1.766643885,113,11
E3361,Marketing,50,54,6.691710734,-1,14,4,20,2,2.340181609,2.600201787,104,18
E3362,Engineering,42,65,9.870232098,0,8,10,31,12,1.655898406,2.851825032,107,18
E3363,Support,63,78,8.048092919,-1,6,3,19,10,0.994684745,2.099890018,141,9
E3364,Finance,42,72,14.70563107,2,11,7,21,11,1.146085752,1.337100044,114,18
E3365,Engineering,57,75,11.2688644,0,10,5,20,5,1.222607041,1.630142721,132,15
E3366,Engineering,45,76,8.112314164,-1,12,3,11,4,1.646124105,1.207157677,121,15
E3367,Marketing,51,56,10.51462981,0,11,5,18,4,1.389536638,1.563228718,107,16
E3368,Operations,38,74,7.271845924,-1,10,8,22,9,2.176056006,2.659624007,112,18
E3369,HR,49,61,12.01442963,1,13,2,17,1,1.152566837,1.306242415,110,15
E3370,Marketing,54,77,10.50312782,0,7,6,25,4,1.130127405,2.173321933,131,13
E3371,Finance,50,66,11.25694044,0,5,6,24,6,0.897450718,1.958074294,116,11
E3372,Operations,40,68,7.139177429,-1,4,7,17,2,1.351487923,2.088663154,108,11
E3373,Finance,57,64,5.848472347,-1,13,2,21,9,2.190269485,3.066377279,121,15
E3374,Operations,45,62,5.009434161,-2,15,8,19,4,3.827315415,3.161695343,107,23
E3375,Support,46,60,5.236705615,-2,5,6,20,3,1.763751679,3.206821235,106,11
E3376,Finance,48,73,10.03265731,0,11,5,12,9,1.450239915,1.087679936,121,16
E3377,Marketing,35,89,15.76545103,2,7,10,19,1,1.013990018,1.133282962,124,17
E3378,Operations,59,71,8.802243916,0,7,2,21,9,0.918157116,2.142366603,130,9
E3379,Operations,61,80,8.263738522,-1,8,4,16,3,1.29537335,1.727164466,141,12
E3380,Engineering,58,75,9.837236396,0,5,6,16,2,1.015018922,1.476391159,133,11
E3381,Engineering,47,74,7.641377492,-1,11,5,21,9,1.851556655,2.430168109,121,16
E3382,Sales,51,64,6.154589461,-1,7,4,25,8,1.53747466,3.494260591,115,11
E3383,Finance,63,58,8.036322859,-1,8,5,27,11,1.438638283,2.987941049,121,13
E3384,Engineering,48,70,9.319127743,0,8,7,22,5,1.453611233,2.131963141,118,15
E3385,Sales,53,65,15.5782107,2,10,3,23,1,0.784161828,1.387363233,118,13
E3386,Support,63,86,8.534474987,0,9,2,20,1,1.153707993,2.097650896,149,11
E3387,Support,39,69,10.58434031,0,7,4,19,6,0.949557739,1.640145186,108,11
E3388,Engineering,41,66,5.884178997,-1,13,2,11,10,2.178909062,1.597866645,107,15
E3389,Finance,48,74,12.08161673,1,10,5,19,1,1.146647262,1.452419865,122,15
E3390,Operations,62,66,7.782104424,-1,9,8,17,10,1.93575471,1.93575471,128,17
E3391,HR,60,62,6.611851384,-1,8,9,25,3,2.233359421,3.28435209,122,17
E3392,Finance,46,75,6.915722682,-1,6,6,25,8,1.515970238,3.15827133,121,12
E3393,Marketing,44,63,8.074232309,-1,14,9,18,5,2.534649678,1.983638878,107,23
E3394,Support,51,74,6.53161303,-1,11,2,15,2,1.726057877,1.991605243,125,13
E3395,Engineering,48,69,10.87385298,0,6,5,25,7,0.926405272,2.105466527,117,11
E3396,Engineering,61,57,6.746955907,-1,5,4,16,9,1.161746641,2.065327361,118,9
E3397,Operations,51,69,11.93756497,1,9,10,16,2,1.468591659,1.236708765,120,19
E3398,Marketing,57,72,8.474140424,-1,2,7,21,2,0.949954254,2.216559926,129,9
E3399,Operations,54,86,7.249108236,-1,9,3,22,1,1.454702697,2.666954945,140,12
E3400,Marketing,52,71,7.950205966,-1,3,7,26,7,1.117292723,2.904961081,123,10
E3401,HR,56,66,6.953166903,-1,11,5,16,7,2.01177722,2.01177722,122,16
E3402,Support,50,73,10.06475359,0,10,7,16,4,1.536410174,1.446033105,123,17
E3403,Engineering,52,69,8.364352413,-1,12,7,26,12,2.028971056,2.776486708,121,19
E3404,Engineering,51,71,13.33413331,1,6,2,23,5,0.558108385,1.604561608,122,8
E3405,HR,44,78,3.084091287,-2,5,1,17,12,1.469115056,4.162492659,122,6
E3406,Sales,39,69,13.50435065,1,11,4,26,6,1.03417246,1.792565598,108,15
E3407,Support,60,71,7.982076168,-1,8,5,19,10,1.447326849,2.115323857,131,13
E3408,Operations,49,54,14.80123423,2,9,6,25,7,0.949292934,1.58215489,103,15
E3409,HR,50,64,10.36146397,0,7,3,27,7,0.880168262,2.376454309,114,10
E3410,Operations,60,61,13.59909642,1,9,5,28,3,0.958963459,1.917926918,121,14
E3411,Finance,60,57,9.771628187,0,11,12,27,5,2.135238944,2.506584848,117,23
E3412,Engineering,53,62,9.587295375,0,5,8,19,12,1.227886777,1.794603752,115,13
E3413,Operations,54,62,7.153397354,-1,2,2,17,9,0.490593041,2.085020423,116,4
E3414,Marketing,58,63,9.72558987,0,8,3,17,12,1.025584619,1.584994411,121,11
E3415,Operations,39,78,7.000504508,-1,12,7,20,6,2.374850234,2.499842351,117,19
E3416,Finance,50,60,10.56191309,0,14,8,10,10,1.902799288,0.864908767,110,22
E3417,Support,38,54,10.48401257,0,12,4,20,11,1.393241248,1.74155156,92,16
E3418,Engineering,45,66,9.632071541,0,10,5,26,12,1.410825721,2.44543125,111,15
E3419,HR,51,61,13.71092959,1,17,7,25,11,1.631440071,1.69941674,112,24
E3420,Finance,45,78,11.4928079,0,5,2,23,1,0.560322391,1.841059286,123,7
E3421,Engineering,65,58,7.239593729,-1,7,4,16,10,1.335017279,1.941843315,123,11
E3422,Operations,46,71,11.70509496,1,6,5,15,8,0.865794394,1.18062872,117,11
E3423,Support,56,64,12.85609792,1,8,1,14,2,0.649533516,1.010385469,120,9
E3424,Sales,56,61,2.816065403,-2,4,6,20,9,2.62050016,5.24100032,117,10
E3425,Support,51,66,6.751030573,-1,8,4,30,4,1.548181224,3.87045306,117,12
E3426,Sales,41,72,8.592775144,0,9,7,20,2,1.667921927,2.084902408,113,16
E3427,Marketing,49,73,7.558280872,-1,4,4,26,8,0.934767171,3.037993306,122,8
E3428,Support,44,63,11.91438016,1,8,8,22,3,1.238928992,1.703527364,107,16
E3429,Engineering,40,66,7.340885208,-1,10,7,26,9,2.038152975,3.117175138,106,17
E3430,Sales,45,65,7.01660923,-1,14,4,16,5,2.245338332,1.995856295,110,18
E3431,HR,44,72,10.71620002,0,6,6,26,4,1.024222869,2.219149549,116,12
E3432,Engineering,46,63,9.307015882,0,6,1,30,11,0.679149046,2.910638767,109,7
E3433,HR,51,70,13.36756943,1,12,9,12,1,1.461625093,0.835214339,121,21
E3434,Support,49,70,11.11280124,0,12,6,20,12,1.486031154,1.651145726,119,18
E3435,HR,55,82,20.20821296,3,10,5,20,12,0.70727317,0.943030893,137,15
E3436,Sales,36,63,6.727885713,-1,9,9,25,1,2.329226993,3.23503749,99,18
E3437,Engineering,49,73,5.413066957,-2,12,5,13,6,2.650837753,2.027111223,122,17
E3438,Operations,47,105,14.12725255,1,3,4,13,7,0.462741002,0.859376146,152,7
E3439,Finance,49,58,19.2000955,3,6,8,15,4,0.69306603,0.742570747,107,14
E3440,Sales,39,72,9.330138179,0,10,2,25,12,1.161649514,2.420103155,111,12
E3441,Sales,54,60,9.045438537,0,6,10,33,8,1.592762719,3.285073108,114,16
E3442,Operations,55,72,10.381853,0,7,5,18,7,1.054309874,1.581464811,127,12
E3443,Engineering,43,69,7.442174495,-1,5,2,22,2,0.829170258,2.605963667,112,7
E3444,Engineering,67,80,4.164850811,-2,4,2,25,5,1.161698608,4.840410869,147,6
E3445,Support,33,63,10.72861879,0,8,0,16,8,0.682092252,1.364184504,96,8
E3446,HR,71,84,10.02868076,0,9,4,18,3,1.178744791,1.632108172,155,13
E3447,Support,48,64,5.849316271,-1,13,9,23,8,3.211999436,3.35799941,112,22
E3448,Operations,50,64,8.148228293,-1,7,4,27,7,1.202418616,2.951391148,114,11
E3449,Support,48,72,5.781142868,-1,11,4,23,5,2.212016513,3.391758653,120,15
E3450,Operations,57,73,11.1145523,0,8,6,20,1,1.155634947,1.650907067,130,14
E3451,Engineering,47,58,9.919304298,0,9,4,20,5,1.190552039,1.831618522,105,13
E3452,HR,53,70,10.48610229,0,12,9,22,8,1.828296447,1.915358182,123,21
E3453,Support,61,79,11.55953824,1,9,5,28,6,1.114690662,2.229381325,140,14
E3454,Sales,48,66,13.28867492,1,8,5,16,7,0.909811447,1.119767935,114,13
E3455,Marketing,64,81,10.53398478,0,6,3,21,2,0.780302746,1.820706408,145,9
E3456,Finance,49,67,11.8455307,1,13,4,26,5,1.32341749,2.024050279,116,17
E3457,Sales,53,65,15.45716152,2,8,4,27,5,0.72916584,1.640623139,118,12
E3458,Engineering,56,63,12.89965681,1,8,6,23,9,1.007219113,1.654717114,119,14
E3459,Finance,40,65,10.65467927,0,10,11,22,3,1.801851387,1.887653834,105,21
E3460,Marketing,38,67,10.47021933,0,6,6,21,5,1.046187493,1.830828112,105,12
E3461,Marketing,41,63,7.512383622,-1,7,7,25,2,1.64466272,2.936897714,104,14
E3462,HR,57,65,8.06068191,-1,3,4,18,1,0.772568783,1.986605443,122,7
E3463,Finance,55,63,9.704030456,0,11,4,18,4,1.401341304,1.681609565,118,15
E3464,HR,44,87,8.93921288,0,8,6,23,12,1.408562244,2.314066544,131,14
E3465,Sales,42,63,15.65643303,2,4,5,23,2,0.540331774,1.380847866,105,9
E3466,Operations,37,63,11.11857774,0,6,4,25,9,0.825179341,2.062948354,100,10
E3467,Operations,61,79,10.87170274,0,11,0,16,4,0.926573066,1.347742641,140,11
E3468,Operations,50,65,13.51953227,1,7,5,21,3,0.826472904,1.446327582,115,12
E3469,Finance,52,62,10.54918085,0,9,7,21,1,1.385379639,1.818310776,114,16
E3470,Operations,36,93,9.172453716,0,11,3,16,11,1.376265785,1.572875183,129,14
E3471,Sales,48,79,10.77499493,0,13,10,21,6,1.953291712,1.783440259,127,23
E3472,HR,43,74,11.21946253,0,16,9,21,3,2.045916498,1.718569859,117,25
E3473,Finance,51,72,14.20053767,1,7,6,23,3,0.855232906,1.513104371,123,13
E3474,HR,47,85,5.927625206,-1,11,6,20,2,2.453943378,2.88699221,132,17
E3475,Finance,45,67,7.78216016,-1,8,3,19,2,1.252539216,2.163476827,112,11
E3476,HR,46,68,9.781252422,0,8,5,11,4,1.205796831,1.020289626,114,13
E3477,Marketing,53,71,12.8116805,1,11,4,16,6,1.086037286,1.158439771,124,15
E3478,HR,47,68,12.36173481,1,5,8,15,12,0.972927557,1.122608719,115,13
E3479,Operations,44,67,10.32501058,0,6,1,17,4,0.618100968,1.50110235,111,7
E3480,Marketing,62,55,13.05790134,1,5,5,21,2,0.711343732,1.493821837,117,10
E3481,HR,55,74,7.978377112,-1,7,4,18,9,1.225165736,2.004816658,129,11
E3482,Finance,47,66,15.65007277,2,5,3,20,8,0.48047838,1.201195951,113,8
E3483,Finance,53,80,7.492904179,-1,6,5,23,8,1.295198882,2.708143117,133,11
E3484,Finance,51,77,4.858303342,-2,8,6,19,1,2.389770414,3.243259847,128,14
E3485,Engineering,56,62,11.81552817,1,6,4,15,10,0.780303384,1.170455076,118,10
E3486,Sales,50,68,5.700138788,-1,12,4,24,3,2.388010235,3.582015352,118,16
E3487,Finance,57,89,8.47331368,-1,7,6,22,11,1.372275894,2.322313052,146,13
E3488,Marketing,49,82,9.570492699,0,8,4,16,12,1.135235636,1.513647514,131,12
E3489,Finance,58,59,11.24466664,0,8,6,14,4,1.143354933,1.143354933,117,14
E3490,Engineering,35,70,13.03880247,1,7,5,16,7,0.854773762,1.139698349,105,12
E3491,Operations,48,65,5.950934178,-1,10,6,10,6,2.301848872,1.438655545,113,16
E3492,Marketing,45,72,6.623431279,-1,5,6,25,3,1.442919808,3.279363201,117,11
E3493,Engineering,39,80,20.24057794,3,12,9,13,8,0.988673663,0.612036077,119,21
E3494,Operations,54,77,9.366540774,0,6,11,15,1,1.639891297,1.446962909,131,17
E3495,Support,46,59,5.069940328,-2,10,5,21,3,2.47119398,3.459671573,105,15
E3496,Support,48,72,6.974321594,-1,9,6,23,1,1.881037756,2.884257893,120,15
E3497,Marketing,53,67,8.417698789,-1,9,5,19,3,1.486562728,2.017477988,120,14
E3498,HR,51,66,10.01495951,0,15,9,14,9,2.178855036,1.270998771,117,24
E3499,Sales,49,72,13.57771111,1,8,5,15,2,0.891772371,1.02896812,121,13
E3500,Sales,51,77,14.90165704,2,10,3,15,2,0.817524863,0.943297919,128,13
E3501,Engineering,52,56,7.526577282,-1,11,4,20,2,1.759205306,2.345607075,108,15
E3502,Operations,54,66,8.296071502,-1,7,7,22,2,1.506012513,2.366591091,120,14
E3503,Sales,47,66,10.44552045,0,9,4,19,1,1.135815541,1.660038098,113,13
E3504,Operations,51,76,7.821894253,-1,3,7,27,11,1.133543399,3.060567178,127,10
E3505,Operations,58,65,13.57848802,1,16,5,20,1,1.440478599,1.37188438,123,21
E3506,Engineering,51,58,17.40014806,2,7,4,23,10,0.597821276,1.249989941,109,11
E3507,Engineering,44,79,10.06400067,0,10,7,22,8,1.536514729,1.988430826,123,17
E3508,Engineering,43,80,10.98528363,0,5,5,20,4,0.834356558,1.668713116,123,10
E3509,Sales,53,82,8.242112821,-1,7,1,19,7,0.865602937,2.055806975,135,8
E3510,Support,51,61,11.00723711,0,11,6,21,7,1.415812801,1.748945224,112,17
E3511,Engineering,56,59,6.819470286,-1,7,6,15,9,1.662516708,1.918288509,115,13
E3512,Sales,44,82,7.152662036,-1,5,4,22,8,1.1039339,2.69850509,126,9
E3513,Engineering,49,73,4.549167229,-2,7,3,16,7,1.802072201,2.883315521,122,10
E3514,Finance,44,68,12.44776689,1,9,1,22,2,0.743617887,1.635959352,112,10
E3515,Operations,37,81,14.16642578,1,2,5,20,4,0.461545792,1.318702263,118,7
E3516,Engineering,54,82,13.0919228,1,10,6,24,1,1.13540219,1.703103285,136,16
E3517,Marketing,53,59,10.28172153,0,7,6,17,6,1.152306407,1.506862224,112,13
E3518,Operations,35,75,9.060018857,0,8,7,24,6,1.491050883,2.385681413,110,15
E3519,Operations,34,73,9.721790399,0,6,3,20,7,0.839412045,1.865360099,107,9
E3520,Engineering,44,80,6.942080655,-1,10,3,27,8,1.636850665,3.399612919,124,13
E3521,Support,49,74,12.82274202,1,7,1,18,8,0.57875637,1.302201833,123,8
E3522,HR,59,69,13.1452321,1,8,4,19,12,0.84834239,1.343208784,128,12
E3523,Support,46,64,6.812603902,-1,12,3,22,8,1.919974465,2.815962549,110,15
E3524,Engineering,46,62,7.197060106,-1,5,4,22,3,1.097954618,2.683889067,108,9
E3525,Operations,47,85,6.02254821,-1,9,5,24,12,1.99357834,3.417562868,132,14
E3526,Marketing,53,78,9.236360274,0,7,3,23,1,0.976909735,2.24689239,131,10
E3527,Operations,46,63,9.934871933,0,9,8,22,4,1.554659268,2.011911994,109,17
E3528,Support,57,57,10.19935288,0,14,3,22,12,1.517944847,1.964399214,114,17
E3529,Marketing,46,70,6.003566701,-1,6,8,21,1,1.998981462,2.998472192,116,14
E3530,Sales,41,61,7.803626461,-1,4,4,22,11,0.908716429,2.49897018,102,8
E3531,Finance,55,81,7.808948085,-1,3,1,19,4,0.45408373,2.156897715,136,4
E3532,Operations,41,63,12.19278034,1,5,6,20,3,0.833789369,1.515980671,104,11
E3533,Engineering,53,81,7.011994383,-1,6,4,23,8,1.248128683,2.870695972,134,10
E3534,Sales,56,76,10.16306858,0,10,1,22,2,0.985392136,1.970784273,132,11
E3535,Finance,58,73,7.87436373,-1,6,8,31,3,1.577577889,3.493208183,131,14
E3536,Engineering,47,62,9.425223232,0,9,10,21,11,1.822502941,2.014345356,109,19
E3537,HR,49,69,12.83671457,1,14,5,21,12,1.373158339,1.517701322,118,19
E3538,Engineering,52,71,6.283464396,-1,15,6,15,9,2.883243311,2.059459508,123,21
E3539,Marketing,62,63,2.178849673,-3,11,4,22,9,4.71868806,6.920742489,125,15
E3540,Marketing,50,67,5.983780697,-1,4,3,26,6,1.002322424,3.722911862,117,7
E3541,HR,57,76,11.25195298,0,10,4,16,3,1.14267497,1.305914252,133,14
E3542,Sales,40,85,6.407483785,-1,8,8,27,11,2.159977729,3.644962417,125,16
E3543,Finance,58,67,7.86198361,-1,5,6,19,11,1.241257091,2.143989522,125,11
E3544,Engineering,55,74,11.361818,0,6,3,24,5,0.728048253,1.941462008,129,9
E3545,Marketing,69,85,12.41171044,1,4,3,22,11,0.521931936,1.640357514,154,7
E3546,Sales,53,64,13.09804631,1,12,11,21,12,1.631431725,1.489568096,117,23
E3547,HR,41,62,11.66206749,1,8,3,25,6,0.868736484,1.974401101,103,11
E3548,Support,71,54,6.622728565,-1,7,2,20,11,1.180679585,2.623732412,125,9
E3549,Operations,38,58,14.81888993,2,12,5,15,10,1.074664536,0.948233414,96,17
E3550,Support,45,72,7.171299376,-1,11,4,17,3,1.835693359,2.080452474,117,15
E3551,Support,44,65,8.091418004,-1,11,5,17,1,1.75990148,1.869895322,109,16
E3552,Marketing,36,63,9.983513833,0,8,6,21,10,1.274637626,1.911956439,99,14
E3553,HR,41,65,10.83618738,0,7,5,21,8,1.013839982,1.774219968,106,12
E3554,Engineering,43,66,14.31580035,1,5,5,30,12,0.652920499,1.958761496,109,10
E3555,Support,54,87,8.10162574,-1,14,6,17,7,2.197409625,1.867798181,141,20
E3556,Support,47,77,11.14124663,0,9,0,24,3,0.741274786,1.976732764,124,9
E3557,Finance,47,88,8.118401257,-1,16,3,18,10,2.083698607,1.974030259,135,19
E3558,Marketing,55,75,14.8225139,2,7,9,16,7,1.011217313,1.011217313,130,16
E3559,Marketing,46,85,11.2816455,0,4,7,26,12,0.895645457,2.116980171,131,11
E3560,Engineering,49,71,13.86780492,1,5,7,18,11,0.807113092,1.210669638,120,12
E3561,Operations,47,88,6.541790167,-1,7,3,13,4,1.325945137,1.723728679,135,10
E3562,Sales,49,52,8.316647321,-1,10,5,15,7,1.610021232,1.610021232,101,15
E3563,Finance,40,67,10.74597552,0,6,6,16,9,1.021626512,1.362168683,107,12
E3564,Marketing,45,68,13.91528936,1,7,5,22,2,0.80454356,1.474996527,113,12
E3565,Finance,48,69,12.97681303,1,10,5,11,1,1.073206028,0.787017754,117,15
E3566,Marketing,53,70,14.50128217,1,15,7,17,10,1.419237439,1.096683476,123,22
E3567,Finance,60,78,14.02400149,1,10,6,21,6,1.064962621,1.39776344,138,16
E3568,HR,46,69,12.33618485,1,8,6,13,4,1.049775491,0.974791527,115,14
E3569,Support,39,66,10.46011416,0,13,1,25,12,1.221628319,2.181479141,105,14
E3570,Marketing,54,63,6.655159856,-1,8,1,20,12,1.175677604,2.612616898,117,9
E3571,Finance,54,66,3.566195313,-2,8,2,11,1,2.190007066,2.409007773,120,10
E3572,Sales,52,52,10.37301351,0,8,0,21,3,0.703419546,1.846476308,104,8
E3573,HR,45,51,12.40794623,1,7,5,22,3,0.894991656,1.640818036,96,12
E3574,HR,45,60,1.827232704,-3,13,3,17,9,5.659244099,6.012946856,105,16
E3575,Sales,54,60,6.477626708,-1,7,4,22,5,1.471054979,2.942109958,114,11
E3576,Finance,52,79,6.950421132,-1,8,3,15,3,1.383574507,1.88669251,131,11
E3577,Engineering,54,56,9.437168823,0,5,6,19,4,1.053925656,1.820417042,110,11
E3578,Sales,49,59,10.30965794,0,11,6,21,1,1.503140068,1.856820084,108,17
E3579,Finance,57,58,13.24431789,1,11,3,22,12,0.982848046,1.5444755,115,14
E3580,Sales,60,78,6.052288689,-1,7,5,18,12,1.701575266,2.552362899,138,12
E3581,Sales,46,85,11.0326803,0,12,5,19,5,1.412819054,1.57903306,131,17
E3582,Marketing,39,61,5.838751176,-1,5,7,22,11,1.754706333,3.216961611,100,12
E3583,Finance,46,68,12.50732966,1,8,3,17,1,0.814372661,1.258575931,114,11
E3584,Engineering,53,61,8.555089206,0,7,3,11,9,1.046562704,1.151218975,114,10
E3585,Support,54,72,6.363564033,-1,7,4,19,8,1.493841834,2.580272259,126,11
E3586,Marketing,56,65,7.983225178,-1,5,7,21,10,1.335823133,2.337690482,121,12
E3587,Sales,58,72,6.653974038,-1,9,5,17,6,1.829115167,2.221068417,130,14
E3588,Support,45,89,10.27646748,0,7,7,18,11,1.241523556,1.596244571,134,14
E3589,Operations,48,66,11.87219616,1,10,1,32,12,0.854555032,2.485978274,114,11
E3590,Support,47,56,13.0936719,1,9,6,21,11,1.06430745,1.49003043,103,15
E3591,Sales,49,84,8.443465634,-1,12,7,20,5,2.011973224,2.117866552,133,19
E3592,Sales,41,62,14.16385394,1,7,6,17,9,0.857301847,1.121087031,103,13
E3593,Finance,46,70,9.926904599,0,8,4,17,12,1.098206715,1.555792846,116,12
E3594,Finance,54,65,13.79536657,1,6,6,14,11,0.811064731,0.946242186,119,12
E3595,Marketing,53,60,9.528213418,0,5,10,24,3,1.424743155,2.279589048,113,15
E3596,Engineering,48,59,9.307116583,0,5,3,14,5,0.776162755,1.358284821,107,8
E3597,Marketing,42,69,11.73529633,1,7,4,22,8,0.863741189,1.727482378,111,11
E3598,HR,51,65,10.92386113,0,11,2,19,12,1.090250873,1.593443583,116,13
E3599,Sales,56,76,8.337748159,-1,7,9,11,4,1.713475211,1.178014208,132,16
E3600,Support,40,90,13.46579091,1,6,4,22,2,0.691286088,1.520829393,130,10
E3601,Operations,45,83,7.12992183,-1,9,3,18,9,1.476028952,2.214043428,128,12
E3602,Sales,51,71,11.73531882,1,7,9,15,2,1.256348602,1.177826815,122,16
E3603,Sales,54,60,11.60343602,1,6,2,23,10,0.634747539,1.824899176,114,8
E3604,Marketing,51,63,13.19377926,1,9,3,21,3,0.845440793,1.479521388,114,12
E3605,Operations,55,63,13.25259967,1,10,8,14,11,1.262927495,0.982276941,118,18
E3606,Operations,41,71,9.454172596,0,5,6,22,4,1.05221144,2.10442288,112,11
E3607,Operations,40,74,10.09837281,0,9,6,25,3,1.35154948,2.252582466,114,15
E3608,Marketing,46,72,9.897365554,0,12,8,32,3,1.835305965,2.936489543,118,20
E3609,Sales,60,78,15.2367245,2,7,3,13,7,0.615887767,0.800654097,138,10
E3610,Marketing,40,71,11.95293344,1,6,5,15,1,0.849228482,1.158038839,111,11
E3611,Finance,50,67,13.13132958,1,12,4,22,11,1.132235995,1.556824493,117,16
E3612,Finance,52,66,9.246851797,0,4,4,28,8,0.780727599,2.732546596,118,8
E3613,Marketing,63,63,6.619942457,-1,14,6,33,4,2.624691737,4.330741366,126,20
E3614,Operations,48,78,7.193593056,-1,4,5,25,9,1.098419209,3.051164468,126,9
E3615,Sales,47,81,13.0374945,1,10,10,25,6,1.424755678,1.780944598,128,20
E3616,Marketing,48,81,7.805172441,-1,13,6,24,2,2.15782259,2.72567064,129,19
E3617,Marketing,50,65,19.58546517,3,8,2,13,7,0.485779647,0.631513541,115,10
E3618,Marketing,55,75,8.783051136,0,10,7,16,7,1.737699186,1.635481587,130,17
E3619,HR,46,76,11.05363984,0,9,6,27,2,1.244437381,2.239987286,122,15
E3620,Finance,43,57,11.04823477,0,5,6,12,5,0.912996817,0.995996528,100,11
E3621,Support,40,54,10.53843416,0,4,6,25,3,0.866668723,2.166671807,94,10
E3622,Operations,47,82,6.340360114,-1,7,7,14,12,1.907263374,1.907263374,129,14
E3623,Engineering,47,71,10.7432602,0,7,1,22,5,0.681241824,1.873415017,118,8
E3624,Support,51,71,10.71699941,0,5,5,18,2,0.853460827,1.536229488,122,10
E3625,Operations,47,76,9.101932979,0,10,3,13,1,1.286882424,1.286882424,123,13
E3626,Engineering,39,80,15.55439915,2,9,3,21,6,0.724882848,1.268544983,119,12
E3627,HR,49,71,5.014286179,-2,7,6,34,6,2.161520023,5.653206214,120,13
E3628,Marketing,52,59,5.466182567,-2,6,8,15,3,2.165110535,2.319761288,111,14
E3629,HR,51,79,12.26112758,1,3,4,13,3,0.527858582,0.980308795,130,7
E3630,HR,58,69,9.73859756,0,15,8,18,3,2.141806681,1.676196533,127,23
E3631,Support,56,70,7.36029782,-1,5,6,14,10,1.315742601,1.674581492,126,11
E3632,Sales,44,70,10.58504856,0,8,4,10,9,1.035817842,0.863181535,114,12
E3633,Support,50,72,12.8781317,1,4,4,13,1,0.576446468,0.93672551,122,8
E3634,Finance,46,77,5.107398537,-2,6,9,19,11,2.456037527,3.110980867,123,15
E3635,Engineering,40,62,12.16861635,1,6,7,25,11,0.987195591,1.898453059,102,13
E3636,Marketing,33,55,10.99248039,0,14,8,17,5,1.834482884,1.417554955,88,22
E3637,Support,47,60,9.311543319,0,6,5,20,9,1.06676563,1.939573872,107,11
E3638,Engineering,43,54,10.73681166,0,10,2,20,12,1.022424177,1.704040295,97,12
E3639,Operations,57,70,10.78742504,0,8,6,14,10,1.187706386,1.187706386,127,14
E3640,Engineering,55,62,11.64957661,1,7,5,21,9,0.948648351,1.660134615,117,12
E3641,Operations,41,74,7.04473826,-1,9,4,24,10,1.615963078,2.983316452,115,13
E3642,Support,51,80,13.26241954,1,10,7,15,12,1.191943621,1.05171496,131,17
E3643,Finance,50,80,12.9769665,1,9,7,19,9,1.144740527,1.359379376,130,16
E3644,Support,55,64,13.06530097,1,10,5,19,2,1.06645425,1.350842051,119,15
E3645,Operations,44,67,4.824463941,-2,7,3,21,3,1.716896199,3.605482018,111,10
E3646,Engineering,59,56,13.43311162,1,3,3,25,9,0.415710774,1.732128224,115,6
E3647,Engineering,46,59,8.893590335,0,5,8,23,12,1.313982039,2.324737453,105,13
E3648,Operations,57,67,11.59227626,1,10,10,9,2,1.588275192,0.714723836,124,20
E3649,HR,45,79,4.054831844,-2,6,2,25,1,1.582644141,4.94576294,124,8
E3650,Finance,54,74,7.950459155,-1,7,3,22,12,1.117261118,2.457974459,128,10
E3651,Sales,62,75,12.52114854,1,15,4,27,11,1.40520607,1.996871783,137,19
E3652,Marketing,46,86,11.57798495,1,7,3,21,11,0.795039908,1.669583807,132,10
E3653,Engineering,54,78,6.760126218,-1,9,3,17,1,1.546366601,2.190686017,132,12
E3654,Marketing,41,61,12.04055999,1,3,1,21,9,0.306735294,1.610360292,102,4
E3655,Sales,47,81,7.551565843,-1,7,3,24,5,1.169376484,2.806503562,128,10
E3656,Support,63,70,9.201765728,0,13,4,31,7,1.666378199,3.038689657,133,17
E3657,Marketing,48,83,6.489619638,-1,10,5,29,10,2.002771933,3.872025737,131,15
E3658,Sales,45,76,11.03004936,0,6,5,19,5,0.914376963,1.579378391,121,11
E3659,Operations,37,85,13.26205423,1,5,3,17,5,0.560929013,1.191974152,122,8
E3660,HR,52,76,12.65491463,1,9,5,37,11,1.02527188,2.709647112,128,14
E3661,Engineering,49,61,7.276911759,-1,10,6,21,10,1.933088145,2.537178191,110,16
E3662,Sales,49,66,9.861458797,0,8,6,26,5,1.288961295,2.393785263,115,14
E3663,Marketing,52,69,5.282291282,-2,5,4,29,2,1.43259833,4.616150175,121,9
E3664,Engineering,38,51,14.09302748,1,9,10,24,6,1.258859432,1.59013823,89,19
E3665,HR,54,61,10.05726879,0,11,7,17,5,1.627888436,1.53745019,115,18
E3666,Operations,59,80,11.94997261,1,4,5,20,2,0.694982165,1.544404811,139,9
E3667,Support,40,65,10.59744682,0,10,6,21,10,1.379614,1.810743375,105,16
E3668,Engineering,50,76,8.121646462,-1,5,3,13,2,0.877034649,1.425181304,126,8
E3669,Support,60,68,8.338408815,-1,9,2,17,1,1.177930868,1.820438614,128,11
E3670,Sales,47,72,11.36723267,0,10,4,25,2,1.132023661,2.021470823,119,14
E3671,HR,54,69,14.91074444,2,11,3,19,3,0.879908545,1.194161597,123,14
E3672,Marketing,44,77,8.971342931,0,7,4,12,12,1.103161337,1.203448731,121,11
E3673,HR,50,67,13.52244684,1,7,4,26,10,0.757448116,1.790331911,117,11
E3674,HR,56,79,12.76805865,1,10,7,15,2,1.23474198,1.089478218,135,17
E3675,Finance,35,73,9.041910033,0,11,7,23,9,1.792487678,2.290400922,108,18
E3676,HR,49,64,13.30053217,1,6,5,25,5,0.769202144,1.74818669,113,11
E3677,HR,47,64,13.0577869,1,3,8,20,1,0.782484475,1.422699045,111,11
E3678,Engineering,44,63,3.564015321,-2,11,7,15,1,3.943895613,3.286579677,107,18
E3679,Marketing,46,74,12.10483579,1,8,6,17,7,1.06830793,1.297231058,120,14
E3680,Engineering,66,67,13.8415671,1,8,4,19,7,0.808539956,1.280188263,133,12
E3681,Engineering,48,59,6.497731795,-1,12,5,12,9,2.267352376,1.60048403,107,17
E3682,Sales,42,85,6.058981491,-1,8,5,15,9,1.841625455,2.124952448,127,13
E3683,Engineering,52,64,10.62387862,0,8,7,25,9,1.290447061,2.150745102,116,15
E3684,Finance,38,71,14.73590087,2,8,3,23,2,0.699038466,1.461625883,109,11
E3685,Finance,43,53,6.736116703,-1,8,4,25,4,1.551165845,3.23159551,96,12
E3686,Support,45,81,5.266375247,-2,10,7,13,7,2.712892115,2.074564559,126,17
E3687,Sales,40,69,8.639657438,0,9,8,17,1,1.763548146,1.763548146,109,17
E3688,Support,39,65,8.221574292,-1,5,7,24,1,1.301296245,2.60259249,104,12
E3689,Support,55,70,4.986583303,-2,6,9,19,9,2.505602819,3.173763571,125,15
E3690,Operations,45,81,8.247477545,-1,3,6,28,5,0.973238373,3.027852716,126,9
E3691,Marketing,60,75,11.04642083,0,5,2,24,2,0.581085461,1.992293009,135,7
E3692,Marketing,42,61,15.56877868,2,5,5,19,11,0.603544787,1.146735095,103,10
E3693,Engineering,51,76,11.68481105,1,10,2,17,10,0.946013303,1.340185513,127,12
E3694,Engineering,53,55,12.4184833,1,8,3,25,9,0.819764779,1.863101772,108,11
E3695,Operations,47,52,6.735060278,-1,12,4,16,6,2.068503596,2.068503596,99,16
E3696,Engineering,37,65,9.716618392,0,6,7,22,5,1.213069228,2.052886386,102,13
E3697,Marketing,43,52,9.339292256,0,8,4,19,3,1.160621027,1.83764996,95,12
E3698,Support,51,71,10.97787964,0,10,5,15,11,1.25230846,1.25230846,122,15
E3699,HR,47,78,11.79029702,1,14,5,15,3,1.485501078,1.172764009,125,19
E3700,Finance,53,77,12.85859873,1,12,5,24,8,1.226675245,1.731776817,130,17
E3701,HR,50,76,10.09572766,0,5,5,27,6,0.901247787,2.433369024,126,10
E3702,HR,42,82,8.431082061,-1,6,3,26,7,0.954291347,2.756841668,124,9
E3703,Marketing,56,84,13.67221416,1,7,3,27,1,0.681560389,1.840213051,140,10
E3704,HR,43,67,12.17540338,1,1,3,15,6,0.303596018,1.138485067,110,4
E3705,Operations,51,67,11.85442582,1,6,5,16,12,0.855736394,1.244707482,118,11
E3706,Sales,41,72,9.881677693,0,13,4,21,12,1.5622591,1.929849477,113,17
E3707,Engineering,48,74,13.64876415,1,5,3,27,3,0.546121155,1.843158899,122,8
E3708,Sales,61,74,6.228812343,-1,11,5,17,9,2.213364968,2.351700278,135,16
E3709,Support,45,85,12.67898564,1,6,7,15,5,0.950362867,1.096572538,130,13
E3710,Finance,49,65,12.66393715,1,13,7,25,5,1.463706967,1.829633709,114,20
E3711,Engineering,52,55,7.29770816,-1,12,4,23,7,1.92824328,2.771849715,107,16
E3712,HR,42,73,7.958379959,-1,8,2,27,8,1.11627326,3.013937802,115,10
E3713,Finance,55,71,6.145266909,-1,6,4,16,3,1.399527845,2.239244552,126,10
E3714,Engineering,48,68,11.53115255,0,7,6,22,12,1.037414551,1.755624626,116,13
E3715,Operations,52,67,2.255238507,-3,13,6,19,4,5.836745898,5.836745898,119,19
E3716,Operations,59,69,10.66963544,0,4,2,21,1,0.514154879,1.799542077,128,6
E3717,Operations,50,61,7.708545393,-1,6,3,22,10,1.033467657,2.526254272,111,9
E3718,Operations,53,54,7.047079743,-1,10,3,19,1,1.615492876,2.361104973,107,13
E3719,HR,53,92,4.365653527,-2,4,2,30,8,1.118223525,5.591117624,145,6
E3720,Sales,50,74,7.341304403,-1,8,2,33,12,1.198853263,3.956215768,124,10
E3721,Engineering,69,62,14.28942751,1,10,4,27,12,0.915665416,1.765926159,131,14
E3722,HR,43,62,7.842407013,-1,5,7,15,5,1.357096544,1.69637068,105,12
E3723,Operations,42,58,11.25942376,0,9,2,25,7,0.897268927,2.03924756,100,11
E3724,Support,44,67,6.72735589,-1,6,5,11,6,1.423514092,1.423514092,111,11
E3725,Sales,55,78,13.07777819,1,6,8,22,10,0.994475109,1.562746599,133,14
E3726,Support,55,72,11.81513946,1,7,7,18,7,1.092457873,1.404588694,127,14
E3727,Finance,53,68,9.316757571,0,10,4,20,10,1.357015506,1.938593581,121,14
E3728,Support,48,72,10.69523794,0,8,8,21,7,1.368078195,1.79560263,120,16
E3729,Finance,54,64,10.95279784,0,4,10,24,11,1.171273888,2.007898094,118,14
E3730,Finance,52,74,6.996938905,-1,12,2,23,8,1.750669871,2.876100502,126,14
E3731,Operations,56,64,7.559695657,-1,7,4,20,7,1.285092419,2.336531671,120,11
E3732,Finance,56,82,12.75374333,1,4,6,22,9,0.727074787,1.599564531,138,10
E3733,Marketing,45,73,14.64001523,2,8,7,16,8,0.95907835,1.023016906,118,15
E3734,Engineering,60,85,10.44053658,0,13,4,16,1,1.48594429,1.398535802,145,17
E3735,Engineering,50,67,12.07786225,1,9,5,15,11,1.070511352,1.146976449,117,14
E3736,Operations,55,72,13.61353536,1,4,4,13,10,0.547437687,0.889586242,127,8
E3737,Marketing,70,71,9.025904888,0,16,5,26,2,2.09457403,2.593282132,141,21
E3738,Support,56,60,9.770416244,0,5,4,21,7,0.835622301,1.949785368,116,9
E3739,HR,51,63,12.1430285,1,7,5,21,9,0.913031574,1.597805254,114,12
E3740,Support,44,71,16.55041937,2,3,5,27,3,0.455829563,1.538424776,115,8
E3741,HR,56,70,12.24752329,1,12,4,20,12,1.207772929,1.509716161,126,16
E3742,Finance,39,88,10.91080262,0,12,6,18,3,1.51123317,1.51123317,127,18
E3743,Sales,52,77,8.238940645,-1,10,7,31,2,1.840037798,3.355363043,129,17
E3744,HR,43,67,9.826048665,0,10,6,24,1,1.477916874,2.216875311,110,16
E3745,Sales,41,64,12.06256168,1,5,11,18,5,1.224874599,1.377983923,105,16
E3746,Engineering,44,62,11.74211523,1,4,5,20,1,0.70631915,1.569598111,106,9
E3747,Sales,43,69,8.201348044,-1,3,4,21,6,0.760758094,2.282274282,112,7
E3748,Engineering,58,66,13.92999636,1,2,6,14,1,0.535834022,0.937709538,124,8
E3749,Marketing,59,63,13.93339353,1,8,4,24,10,0.803568189,1.607136379,122,12
E3750,Marketing,58,62,9.667138345,0,10,2,19,6,1.124950255,1.781171237,120,12
E3751,Operations,39,69,10.84067922,0,6,8,20,4,1.182364604,1.689092291,108,14
E3752,Operations,49,68,8.077692807,-1,2,8,18,10,1.101601499,1.982882697,117,10
E3753,Finance,50,71,7.573943406,-1,10,5,11,6,1.749486705,1.282956917,121,15
E3754,HR,53,73,11.04131466,0,9,2,26,2,0.913521514,2.15923267,126,11
E3755,Finance,64,72,7.658491774,-1,7,8,29,6,1.732403332,3.349313109,136,15
E3756,Engineering,61,58,11.94544237,1,8,3,18,5,0.8497199,1.390450746,119,11
E3757,Finance,48,71,8.808821689,0,8,4,9,10,1.223388535,0.917541402,119,12
E3758,Sales,57,79,13.1504929,1,6,3,22,6,0.636020248,1.554716161,136,9
E3759,Engineering,53,77,9.743166422,0,10,4,17,8,1.303153972,1.582401252,130,14
E3760,Operations,54,73,4.229800517,-2,6,9,19,9,2.868178232,3.63302576,127,15
E3761,Marketing,52,60,8.883547854,0,13,4,30,11,1.72003012,3.03534727,112,17
E3762,Operations,55,65,10.32061692,0,9,6,23,2,1.325016128,2.031691397,120,15
E3763,HR,55,75,4.798755312,-2,14,6,25,7,3.449016025,4.311270032,130,20
E3764,Engineering,49,68,5.077233827,-2,9,6,23,12,2.468228215,3.784616596,117,15
E3765,Engineering,42,58,9.437241641,0,8,4,18,1,1.149729058,1.724593587,100,12
E3766,Sales,45,68,13.01376686,1,8,7,22,9,1.07037602,1.56988483,113,15
E3767,HR,40,75,11.89417097,1,9,12,21,3,1.6286429,1.6286429,115,21
E3768,Marketing,40,72,9.956670517,0,6,7,25,10,1.186491825,2.281715048,112,13
E3769,Support,49,78,7.442068715,-1,10,4,13,9,1.658361294,1.539906916,127,14
E3770,Engineering,52,90,7.296037069,-1,14,4,23,4,2.169710652,2.772408056,142,18
E3771,Engineering,49,67,11.94735367,1,10,7,18,1,1.313009626,1.390245487,116,17
E3772,Sales,57,63,10.59455866,0,6,9,22,8,1.293710304,1.897441779,120,15
E3773,Finance,49,76,12.56321867,1,5,8,27,11,0.958474556,1.990677925,125,13
E3774,Marketing,51,60,13.61200106,1,15,5,16,1,1.368737925,1.09499034,111,20
E3775,Operations,54,72,8.637896284,0,12,7,18,8,1.971384568,1.867627485,126,19
E3776,HR,50,79,11.32035708,0,4,3,23,3,0.56816535,1.866829009,129,7
E3777,Engineering,48,76,11.71643713,1,3,4,23,9,0.550468652,1.808682712,124,7
E3778,Engineering,44,76,7.907766302,-1,5,4,17,4,1.010354301,1.908447014,120,9
E3779,Operations,48,67,8.064985258,-1,6,6,18,9,1.323774905,1.985662358,115,12
E3780,Marketing,52,76,12.16826102,1,8,6,15,8,1.063162401,1.139102573,128,14
E3781,Finance,40,66,10.00520185,0,8,3,13,1,0.999527328,1.181259569,106,11
E3782,Engineering,51,79,7.381353328,-1,7,6,16,12,1.55106216,1.908999582,130,13
E3783,Marketing,55,97,7.542609405,-1,4,4,24,7,0.936482007,2.809446021,152,8
E3784,Operations,46,70,6.148505673,-1,8,6,22,6,1.958451268,3.077566278,116,14
E3785,Sales,39,69,8.925235636,0,8,5,18,10,1.309792581,1.813558958,108,13
E3786,Finance,49,75,6.913277854,-1,5,6,19,6,1.390068718,2.401027785,124,11
E3787,HR,59,92,10.3066723,0,9,8,14,5,1.503536987,1.238206931,151,17
E3788,Engineering,50,64,16.84363104,2,7,3,13,10,0.560424051,0.728551267,114,10
E3789,Marketing,57,76,11.38105523,0,8,4,17,12,0.969222718,1.373065517,133,12
E3790,Sales,49,68,13.20132712,1,8,6,15,6,0.985823359,1.056239313,117,14
E3791,HR,56,62,11.20191356,0,8,7,16,3,1.22931538,1.311269738,118,15
E3792,Support,54,70,5.052074418,-2,1,6,23,1,1.15662821,3.800349832,124,7
E3793,Marketing,62,65,10.37965592,0,10,6,20,9,1.406017908,1.757522385,127,16
E3794,Marketing,43,58,7.952020439,-1,7,5,18,3,1.340479513,2.01071927,101,12
E3795,HR,55,62,7.526602289,-1,8,3,16,10,1.290080108,1.876480157,117,11
E3796,Sales,42,56,9.320457653,0,9,8,19,12,1.647213774,1.84100363,98,17
E3797,Support,46,72,11.89311236,1,5,7,18,3,0.930729499,1.396094248,118,12
E3798,Operations,42,71,9.084390155,0,13,6,22,3,1.884100051,2.181589532,113,19
E3799,Sales,58,59,12.57626662,1,9,4,24,10,0.957553381,1.767790857,117,13
E3800,Finance,46,74,10.54965538,0,13,4,21,6,1.47190539,1.81823607,120,17
E3801,Engineering,54,69,10.95199498,0,8,7,20,7,1.255020607,1.67336081,123,15
E3802,HR,33,79,9.822692353,0,4,3,24,5,0.646789151,2.217562804,112,7
E3803,Operations,41,84,13.85773455,1,8,5,18,9,0.874965154,1.211490213,125,13
E3804,Support,61,71,7.897197705,-1,12,5,24,9,1.910713976,2.697478554,132,17
E3805,HR,51,87,8.067089664,-1,6,6,25,1,1.323467667,2.757224305,138,12
E3806,HR,52,66,9.045356933,0,11,6,19,1,1.692324137,1.891421094,118,17
E3807,Sales,44,56,11.50709431,0,9,6,21,1,1.199319333,1.679047066,100,15
E3808,Engineering,59,70,11.91158802,1,8,7,19,3,1.161747105,1.471546333,129,15
E3809,Finance,58,69,8.319128569,-1,8,7,15,2,1.609592559,1.609592559,127,15
E3810,Marketing,48,72,12.69057149,1,7,11,19,9,1.314773456,1.387816426,120,18
E3811,Marketing,54,67,7.058974288,-1,9,4,21,9,1.613108509,2.605790669,121,13
E3812,HR,53,88,12.13860385,1,7,8,18,2,1.141673816,1.370008579,141,15
E3813,Engineering,39,56,11.07301805,0,6,5,23,10,0.911122634,1.905074598,95,11
E3814,Support,48,63,10.0521929,0,13,3,16,5,1.447676505,1.447676505,111,16
E3815,Support,48,53,11.41937163,0,7,3,27,5,0.805193717,2.174023035,101,10
E3816,Operations,58,75,9.642839322,0,10,6,27,6,1.503358222,2.536917,133,16
E3817,Sales,48,68,10.76569612,0,6,8,25,11,1.189899846,2.124821154,116,14
E3818,Engineering,51,76,17.21822051,2,10,6,16,2,0.878241648,0.878241648,127,16
E3819,Engineering,51,71,12.68296983,1,6,2,20,7,0.584668394,1.461670986,122,8
E3820,Sales,54,67,8.373518703,-1,6,7,18,10,1.386885802,1.920303418,121,13
E3821,Support,38,74,9.084235342,0,13,10,19,1,2.280787707,1.884128975,112,23
E3822,Support,41,78,13.62461674,1,9,5,21,10,0.957290044,1.435935065,119,14
E3823,Support,50,69,8.815586606,0,6,3,20,4,0.916909031,2.037575624,119,9
E3824,HR,57,65,15.10232201,2,6,2,17,8,0.496822756,1.055748356,122,8
E3825,Engineering,59,66,12.29611499,1,6,3,21,4,0.676889453,1.579408724,125,9
E3826,Marketing,43,55,5.931922587,-1,7,3,15,12,1.442601223,2.163901834,98,10
E3827,Sales,61,71,12.60500034,1,8,2,22,1,0.73502387,1.617052514,132,10
E3828,Support,46,78,3.530952531,-2,6,3,15,12,1.986337296,3.310562161,124,9
E3829,Operations,54,67,8.954809132,0,8,3,19,3,1.104993562,1.908625243,121,11
E3830,Support,46,71,12.56557357,1,11,5,10,8,1.179456211,0.737160132,117,16
E3831,Support,53,76,4.401260482,-2,8,7,24,7,2.777129533,4.443407253,129,15
E3832,Finance,47,72,16.08845055,2,12,5,24,6,0.994823957,1.404457351,119,17
E3833,HR,44,77,12.90528318,1,12,6,18,7,1.29447202,1.29447202,121,18
E3834,Sales,45,54,7.063392707,-1,4,2,17,12,0.744103657,2.108293694,99,6
E3835,Finance,56,77,14.56003702,2,8,1,21,9,0.578404793,1.349611185,133,9
E3836,Finance,43,59,4.271085668,-2,6,4,23,3,1.897142378,4.36342747,102,10
E3837,Operations,49,77,6.977260254,-1,6,8,21,11,1.754988499,2.632482749,126,14
E3838,Engineering,54,70,5.754656771,-1,10,3,14,8,1.924598161,2.072644173,124,13
E3839,Operations,40,59,4.075144388,-2,6,5,20,1,2.16742602,3.940774581,99,11
E3840,Engineering,50,67,9.000502644,0,7,4,18,4,1.099944712,1.799909529,117,11
E3841,Engineering,55,81,10.57345225,0,8,4,13,10,1.036855706,1.123260348,136,12
E3842,Sales,48,76,10.48387888,0,3,4,27,8,0.609550142,2.351121976,124,7
E3843,Support,44,64,10.39113505,0,9,4,19,12,1.141238335,1.66796372,108,13
E3844,Sales,51,75,10.15774106,0,5,6,14,5,0.985862635,1.254734262,126,11
E3845,HR,43,68,6.455640638,-1,8,6,19,12,1.877772908,2.548406089,111,14
E3846,Engineering,43,97,8.492544727,-1,10,1,20,8,1.158804126,2.106916593,140,11
E3847,Finance,54,53,1.747272775,-3,13,2,20,7,5.459960196,7.279946928,107,15
E3848,Support,51,76,13.23867232,1,10,10,21,4,1.404625343,1.47485661,127,20
E3849,Marketing,73,72,10.28382972,0,7,5,18,8,1.063468725,1.595203087,145,12
E3850,HR,48,65,10.20496805,0,10,2,24,3,1.070953522,2.141907044,113,12
E3851,Sales,49,67,12.33822511,1,3,8,19,1,0.824697433,1.424477384,116,11
E3852,Operations,55,61,12.55291395,1,9,3,22,5,0.885418445,1.623267149,116,12
E3853,HR,49,74,8.916462928,0,12,5,18,12,1.714320935,1.815163343,123,17
E3854,HR,51,72,9.649363078,0,9,7,26,11,1.502437271,2.441460565,123,16
E3855,Support,43,74,14.69840578,2,8,5,33,6,0.828109566,2.102124283,117,13
E3856,HR,35,78,8.244131893,-1,8,6,17,7,1.514474281,1.839004484,113,14
E3857,HR,49,72,14.67167225,2,8,4,21,1,0.765712797,1.339997396,121,12
E3858,Marketing,55,53,8.949013105,0,4,7,23,4,1.105637301,2.311787085,108,11
E3859,Operations,56,79,4.275333637,-2,8,9,22,6,3.222544993,4.170352344,135,17
E3860,Operations,55,69,10.26855992,0,5,4,22,7,0.798682357,1.952334651,124,9
E3861,Operations,47,54,8.925835089,0,7,3,16,7,1.007471906,1.61195505,101,10
E3862,Engineering,61,65,5.95520324,-1,6,6,21,2,1.725327009,3.019322265,126,12
E3863,Finance,47,62,9.756965904,0,8,9,23,3,1.580371282,2.138149382,109,17
E3864,Operations,49,62,8.543489849,0,7,7,29,11,1.466968606,3.038720684,111,14
E3865,HR,45,69,15.62158465,2,9,6,15,5,0.902441032,0.902441032,114,15
E3866,HR,49,64,12.905467,1,10,1,24,3,0.791055777,1.725939876,113,11
E3867,Operations,63,66,7.116121759,-1,17,5,19,6,2.710654257,2.341019586,129,22
E3868,Support,60,75,7.779221918,-1,5,5,22,4,1.139053107,2.505916835,135,10
E3869,Operations,47,67,13.0017426,1,7,4,23,9,0.785616499,1.642652679,114,11
E3870,HR,48,69,13.63755012,1,8,3,19,6,0.751491876,1.298031422,117,11
E3871,Engineering,60,80,9.000659795,0,7,4,18,10,1.099927427,1.799881245,140,11
E3872,Sales,58,64,8.557259779,0,8,6,19,4,1.464855024,1.988017532,122,14
E3873,Sales,46,75,9.618526819,0,8,7,19,7,1.412625335,1.789325424,121,15
E3874,Operations,44,62,10.86995428,0,7,5,17,10,1.010955874,1.432187488,106,12
E3875,Marketing,52,76,12.17692787,1,9,8,16,3,1.290133798,1.214243574,128,17
E3876,Operations,57,62,12.33217595,1,4,4,27,4,0.600052087,2.025175793,119,8
E3877,Support,46,70,6.833109553,-1,13,3,18,10,2.042611544,2.297937987,116,16
E3878,Operations,44,63,8.920873906,0,10,4,13,5,1.411166005,1.310368434,107,14
E3879,Sales,57,69,3.736449391,-2,7,8,21,12,3.166929225,4.433700916,126,15
E3880,HR,39,75,9.929403517,0,8,5,20,9,1.18945192,1.829926031,114,13
E3881,Operations,49,77,5.836447445,-1,8,3,17,2,1.609022828,2.486671643,126,11
E3882,HR,43,63,7.804572163,-1,6,5,17,8,1.249350882,1.930815,106,11
E3883,HR,56,67,13.31213109,1,8,9,25,4,1.187803542,1.746769915,123,17
E3884,Marketing,54,55,11.17011886,0,5,3,11,8,0.65734773,0.903853128,109,8
E3885,HR,62,75,11.04723008,0,5,7,24,5,0.99607959,1.992159181,137,12
E3886,Sales,57,64,10.00691402,0,9,2,15,11,0.999371848,1.362779792,121,11
E3887,Engineering,46,55,14.21134659,1,9,6,18,9,0.986105991,1.183327189,101,15
E3888,Engineering,56,83,8.116495376,-1,4,3,19,6,0.767838924,2.084134222,139,7
E3889,Finance,52,74,10.4908291,0,8,6,18,2,1.218362911,1.5664666,126,14
E3890,Support,65,60,10.33057053,0,6,8,18,2,1.235595328,1.588622564,125,14
E3891,Operations,57,66,8.9543818,0,6,4,16,8,1.004582726,1.607332361,123,10
E3892,Support,47,92,16.41491082,2,9,7,26,4,0.91875291,1.492973479,139,16
E3893,Sales,49,67,6.337220527,-1,9,4,21,10,1.771788098,2.862119235,116,13
E3894,HR,39,68,4.455241767,-2,13,3,24,8,2.93295892,4.399438379,107,16
E3895,Engineering,47,76,10.32397764,0,7,3,15,9,0.883081927,1.324622891,123,10
E3896,Support,58,74,8.190890211,-1,8,6,14,12,1.523247442,1.523247442,132,14
E3897,Sales,48,89,3.03581656,-2,6,6,20,4,2.973375975,4.955626626,137,12
E3898,Engineering,50,68,11.12758037,0,7,4,14,10,0.907023467,1.154393504,118,11
E3899,HR,51,79,10.72535036,0,12,6,22,5,1.535135365,1.876276557,130,18
E3900,Support,50,70,13.36685954,1,3,4,17,1,0.487232438,1.183278778,120,7
E3901,Engineering,49,79,8.331930826,-1,9,8,17,10,1.821702316,1.821702316,128,17
E3902,Operations,62,71,4.422936353,-2,9,6,21,8,2.766029144,3.872440802,133,15
E3903,Operations,57,84,7.185023817,-1,9,4,20,10,1.588266606,2.443487086,141,13
E3904,Finance,61,54,4.234454992,-2,10,3,21,6,2.483544136,4.011878989,115,13
E3905,Finance,45,66,14.49026789,1,5,2,21,6,0.451896639,1.355689918,111,7
E3906,Engineering,50,83,13.01740473,1,9,1,22,2,0.71339882,1.569477404,133,10
E3907,Sales,42,69,13.8500032,1,9,4,27,4,0.875420687,1.818181427,111,13
E3908,Operations,60,73,11.99938512,1,7,5,18,6,0.923120585,1.384680878,133,12
E3909,Sales,55,61,5.798731707,-1,5,8,23,3,1.912121343,3.382983914,116,13
E3910,Sales,52,80,8.787910067,0,9,5,23,11,1.430335986,2.349837692,132,14
E3911,Engineering,59,53,12.37749127,1,5,4,17,10,0.672771883,1.270791335,112,9
E3912,Sales,41,79,4.901844775,-2,4,4,20,1,1.355508372,3.388770929,120,8
E3913,Operations,54,81,11.32228977,0,8,4,16,5,0.973844977,1.29845997,135,12
E3914,HR,46,77,12.33492469,1,11,7,24,4,1.349838895,1.799785193,123,18
E3915,Finance,49,72,16.78968259,2,9,3,21,6,0.674548292,1.180459511,121,12
E3916,HR,46,80,12.86660808,1,15,9,22,11,1.730776544,1.586545165,126,24
E3917,Sales,49,71,11.42522218,0,2,3,18,6,0.402407291,1.448666249,120,5
E3918,HR,45,75,10.08540322,0,11,3,15,5,1.262922035,1.353130752,120,14
E3919,Operations,47,78,11.62973773,1,11,2,24,9,1.029316703,1.90027699,125,13
E3920,Operations,42,75,11.83145359,1,6,8,26,2,1.091068903,2.026270821,117,14
E3921,Sales,37,63,3.785314967,-2,10,2,24,8,2.507671926,5.015343852,100,12
E3922,Engineering,52,56,10.64031065,0,6,2,9,4,0.687266882,0.773175242,108,8
E3923,HR,51,62,2.065912317,-3,7,4,20,1,3.587839071,6.523343765,113,11
E3924,Engineering,39,65,3.238533377,-2,12,4,13,3,3.774890647,3.06709865,104,16
E3925,Engineering,41,75,10.12619222,0,9,6,21,2,1.348170129,1.887438181,116,15
E3926,Marketing,50,68,11.435718,0,10,9,15,10,1.527857097,1.206202972,118,19
E3927,Sales,52,74,6.022165468,-1,11,5,25,3,2.278499428,3.560155356,126,16
E3928,Finance,56,59,13.28147567,1,12,8,23,12,1.400415507,1.610477833,115,20
E3929,Operations,43,65,14.55851475,2,5,4,22,1,0.578461386,1.41401672,108,9
E3930,Operations,46,75,12.41783267,1,7,7,19,3,1.043387583,1.416026005,121,14
E3931,Sales,67,62,9.919841162,0,10,3,21,11,1.190493507,1.923104896,129,13
E3932,Support,44,64,10.91877408,0,6,6,22,10,1.006814956,1.845827419,108,12
E3933,Support,55,75,10.3386319,0,6,8,21,12,1.234716862,1.852075294,130,14
E3934,Support,37,68,10.64194539,0,9,6,24,10,1.288444456,2.06151113,105,15
E3935,Finance,57,79,6.927559215,-1,9,4,16,7,1.639848994,2.018275684,136,13
E3936,Operations,51,64,8.882175529,0,8,2,24,5,1.011922928,2.428615028,115,10
E3937,Sales,32,65,10.17873737,0,4,1,21,7,0.447277705,1.878566363,97,5
E3938,Operations,60,67,11.01144815,0,10,5,16,5,1.248808621,1.332062529,127,15
E3939,Engineering,52,78,11.76864359,1,11,1,17,3,0.939802252,1.331386524,130,12
E3940,HR,53,72,7.004665242,-1,4,2,19,7,0.749562888,2.373615813,125,6
E3941,HR,55,68,9.481677641,0,9,3,19,12,1.144854899,1.812686924,123,12
E3942,Operations,52,70,9.194706468,0,6,6,27,3,1.177081463,2.648433291,122,12
E3943,Marketing,47,70,15.87847167,2,11,4,16,3,0.888706057,0.947953127,117,15
E3944,Finance,60,55,10.74928362,0,8,1,19,8,0.766004149,1.617119869,115,9
E3945,Support,53,67,12.0212788,1,10,3,31,8,0.998365844,2.380718552,120,13
E3946,Finance,54,74,12.98941963,1,1,8,26,11,0.643343344,1.858547437,128,9
E3947,Finance,48,83,12.5614555,1,7,0,22,6,0.516168784,1.622244751,131,7
E3948,Engineering,43,60,3.896347022,-2,7,5,20,8,2.450806682,4.084677804,103,12
E3949,Finance,46,54,9.465313766,0,6,4,19,1,0.955537524,1.815521295,100,10
E3950,HR,60,72,12.03397269,1,15,4,24,3,1.457729002,1.841341897,132,19
E3951,Engineering,48,58,10.39044733,0,8,4,23,12,1.053514375,2.019235886,106,12
E3952,Sales,47,68,4.996051935,-2,10,6,11,2,2.668422518,1.834540481,115,16
E3953,Finance,49,77,6.869713532,-1,7,2,24,6,1.143624855,3.049666281,126,9
E3954,Finance,60,59,7.336506038,-1,8,8,15,7,1.919269287,1.799314957,119,16
E3955,Sales,53,85,10.98469413,0,8,1,26,11,0.750957839,2.169433756,138,9
E3956,Finance,45,72,10.70243292,0,8,4,18,5,1.025427796,1.538141694,117,12
E3957,Sales,54,71,14.57151232,2,12,8,24,3,1.284396762,1.541276115,125,20
E3958,Engineering,34,66,10.03785344,0,8,4,18,1,1.087167905,1.630751858,100,12
E3959,HR,41,75,10.61069155,0,7,2,19,1,0.775147627,1.636422768,116,9
E3960,Sales,42,71,5.989089882,-1,8,8,20,3,2.289282334,2.861602918,113,16
E3961,Marketing,58,61,9.532512141,0,4,6,18,3,0.949441108,1.708993995,119,10
E3962,Sales,54,65,16.82015469,2,13,7,21,2,1.122324713,1.178440949,119,20
E3963,Finance,59,64,11.02633311,0,13,7,29,3,1.663017298,2.411375082,123,20
E3964,Support,53,66,8.320341174,-1,6,4,16,5,1.072922097,1.716675356,119,10
E3965,Support,44,67,11.24659929,0,13,3,22,11,1.306485141,1.796417069,111,16
E3966,Engineering,67,62,13.12583245,1,6,9,25,5,1.061884321,1.769807202,129,15
E3967,Operations,48,77,11.4933838,0,5,4,18,11,0.720381295,1.44076259,125,9
E3968,Engineering,57,70,12.49474577,1,10,8,18,11,1.333852472,1.333852472,127,18
E3969,Operations,56,55,12.87795504,1,9,4,20,1,0.936737435,1.441134515,111,13
E3970,Support,44,81,10.4704256,0,7,2,17,12,0.78462651,1.482072296,125,9
E3971,Support,38,85,10.98716934,0,8,4,24,3,1.001070366,2.002140732,123,12
E3972,Sales,41,71,8.205240177,-1,10,5,24,5,1.629506641,2.607210626,112,15
E3973,HR,48,68,8.171579123,-1,10,6,16,4,1.74451965,1.74451965,116,16
E3974,Marketing,66,76,9.758510413,0,5,6,18,12,1.022446378,1.673094072,142,11
E3975,Engineering,54,69,6.026828006,-1,10,3,21,2,1.850052398,2.988546181,123,13
E3976,Finance,39,82,11.10659476,0,5,7,20,10,0.991195314,1.65199219,121,12
E3977,Operations,51,71,7.611127253,-1,9,4,12,11,1.509674589,1.393545775,122,13
E3978,Finance,60,73,10.53676716,0,11,4,22,5,1.300190929,1.906946695,133,15
E3979,HR,40,63,11.55171816,1,7,3,17,3,0.796703676,1.354396249,103,10
E3980,Operations,41,63,6.049813783,-1,10,5,17,5,2.127715775,2.411411212,104,15
E3981,Engineering,52,78,11.2301919,0,11,3,25,12,1.144708122,2.044121646,130,14
E3982,Sales,51,72,3.804184588,-2,8,2,22,1,2.081518688,4.579341113,123,10
E3983,Finance,53,63,11.76605241,1,10,3,20,11,1.018325758,1.566655013,116,13
E3984,HR,51,89,11.80776229,1,4,4,15,12,0.624621212,1.171164772,140,8
E3985,Engineering,43,53,12.01098402,1,7,3,12,11,0.768581376,0.922297651,96,10
E3986,Support,54,77,11.03132718,0,4,3,23,7,0.581814449,1.911676048,131,7
E3987,Support,40,76,8.445472658,-1,6,5,21,5,1.164579095,2.223287363,116,11
E3988,Engineering,45,79,8.552007125,0,9,1,23,11,1.046900392,2.407870901,124,10
E3989,Engineering,48,91,8.151632006,-1,8,3,20,9,1.201971407,2.185402559,139,11
E3990,Engineering,55,63,13.08919684,1,7,3,19,7,0.709763666,1.348550966,118,10
E3991,Operations,51,68,15.07207151,2,9,7,15,11,0.99551573,0.933295997,119,16
E3992,Engineering,64,61,10.25328767,0,11,15,17,12,2.310435916,1.510669638,125,26
E3993,Finance,45,61,7.035520866,-1,5,5,20,12,1.244474399,2.488948798,106,10
E3994,HR,49,56,9.165833149,0,4,4,29,8,0.786949764,2.852692895,105,8
E3995,Operations,50,80,12.93701629,1,11,4,23,7,1.076270536,1.650281489,130,15
E3996,Engineering,53,64,11.6618418,1,6,1,16,12,0.552842162,1.263639228,117,7
E3997,Marketing,36,78,10.1018049,0,9,7,27,9,1.441207096,2.432036975,114,16
E3998,Marketing,47,60,9.207067215,0,9,5,27,9,1.371598688,2.645226041,107,14
E3999,HR,45,75,4.934668032,-2,7,6,26,1,2.190518481,4.381036961,120,13
E4000,Support,50,60,9.355362774,0,7,6,28,2,1.255388178,2.703912998,110,13
E4001,Sales,52,74,8.837119082,0,5,6,24,6,1.118213565,2.439738688,126,11
E4002,Sales,52,86,8.736440526,0,8,3,25,8,1.129776325,2.567673467,138,11
E4003,Support,33,73,10.84487237,0,7,3,26,12,0.844247172,2.195042648,106,10
E4004,Operations,49,75,15.25135854,2,7,4,27,4,0.676866489,1.661399565,124,11
E4005,Operations,49,57,10.05935609,0,10,1,26,9,0.994632952,2.350950615,106,11
E4006,Operations,57,69,11.79489324,1,9,7,19,2,1.250498906,1.484967451,126,16
E4007,Sales,47,72,9.817936624,0,8,6,18,6,1.294146979,1.663903259,119,14
E4008,Marketing,57,78,9.816822644,0,9,5,19,8,1.294280258,1.756523207,135,14
E4009,Sales,56,65,13.42228903,1,8,3,18,2,0.762708331,1.248068179,121,11
E4010,Finance,52,71,11.12107888,0,7,1,24,1,0.660007255,1.980021765,123,8
E4011,Engineering,46,68,12.33685103,1,8,5,16,7,0.974742837,1.199683491,114,13
E4012,Operations,49,70,13.71955803,1,7,7,20,10,0.951115514,1.358736449,119,14
E4013,Marketing,43,60,11.08868194,0,11,6,18,9,1.406274074,1.488996078,103,17
E4014,HR,54,79,10.73368672,0,12,3,15,8,1.278370588,1.278370588,133,15
E4015,HR,48,62,12.21079328,1,7,4,16,8,0.832652496,1.211130904,110,11
E4016,Engineering,35,88,8.053432787,-1,10,10,27,7,2.209106807,2.98229419,123,20
E4017,Marketing,57,71,8.104849146,-1,11,1,16,8,1.317979003,1.757305337,128,12
E4018,Sales,47,76,7.723723324,-1,7,4,19,8,1.26092949,2.177969119,123,11
E4019,Sales,49,86,8.528211934,-1,10,4,21,4,1.469320802,2.203981203,135,14
E4020,Finance,51,64,6.439278161,-1,6,3,23,3,1.209794795,3.09169781,115,9
E4021,Finance,58,66,5.030807121,-2,2,5,21,12,1.160706993,3.48212098,124,7
E4022,Sales,46,85,7.534611998,-1,8,2,26,4,1.171699428,3.046418514,131,10
E4023,HR,54,82,2.943451342,-2,4,4,24,8,2.02867978,6.08603934,136,8
E4024,Operations,52,64,10.85170647,0,15,10,21,12,2.109400875,1.771896735,116,25
E4025,HR,46,70,10.29625886,0,7,3,21,7,0.885248836,1.859022555,116,10
E4026,Finance,57,83,12.2233614,1,13,9,19,5,1.663722206,1.436850996,140,22
E4027,Engineering,55,70,7.202475761,-1,8,6,17,2,1.706801752,2.072544985,125,14
E4028,Sales,46,67,11.4967719,0,5,6,16,9,0.880227317,1.280330643,113,11
E4029,Finance,44,76,7.574321831,-1,12,5,20,10,1.982664091,2.33254599,120,17
E4030,Finance,44,71,12.32238561,1,8,5,25,6,0.97580121,1.876540788,115,13
E4031,Operations,48,80,4.534270331,-2,9,3,20,2,2.168307524,3.613845874,128,12
E4032,Sales,45,68,9.288113027,0,7,3,19,11,0.971995542,1.84679153,113,10
E4033,Operations,56,72,8.802685814,0,9,4,18,1,1.326167159,1.836231451,128,13
E4034,Sales,59,70,12.39085055,1,5,8,24,6,0.970812119,1.792268528,129,13
E4035,Operations,60,71,12.34600891,1,6,10,19,11,1.198860281,1.423646584,131,16
E4036,HR,49,83,13.65646287,1,13,2,13,3,1.023439293,0.88698072,132,15
E4037,Engineering,45,69,3.957252954,-2,10,4,19,3,2.824144769,3.832767901,114,14
E4038,Engineering,46,51,14.48863407,1,10,7,24,12,1.097579033,1.54952334,97,17
E4039,Sales,46,77,7.223144311,-1,10,2,14,10,1.459295805,1.702511773,123,12
E4040,Marketing,48,68,15.12430408,2,6,5,17,9,0.682199985,1.054309068,116,11
E4041,Support,43,67,16.67112626,2,10,6,17,12,0.905431819,0.962021308,110,16
E4042,Finance,58,82,13.57323531,1,8,5,19,11,0.892046257,1.303759913,140,13
E4043,Finance,60,73,7.428124979,-1,10,11,22,7,2.491657403,2.610307756,133,21
E4044,Sales,52,72,6.266565914,-1,6,2,25,3,1.100932696,3.440414674,124,8
E4045,Operations,46,66,7.88424607,-1,10,1,23,6,1.238146705,2.588852202,112,11
E4046,Marketing,57,71,11.7113727,1,5,7,18,11,0.944036516,1.416054774,128,12
E4047,HR,49,65,6.810031833,-1,5,4,15,8,1.152364061,1.920606768,114,9
E4048,Operations,55,64,4.424703273,-2,13,6,19,3,3.502495721,3.502495721,119,19
E4049,Operations,50,64,13.24330471,1,10,2,22,5,0.842501108,1.544585364,114,12
E4050,Sales,53,73,8.198915926,-1,5,8,19,5,1.413210003,2.065460773,126,13
E4051,Sales,56,79,12.74357192,1,9,0,26,11,0.654851596,1.891793499,135,9
E4052,Finance,56,79,12.31494557,1,6,5,17,1,0.826139314,1.276760758,135,11
E4053,Sales,48,71,10.59287388,0,6,8,14,11,1.207638429,1.207638429,119,14
E4054,Sales,56,72,12.51807659,1,4,3,22,5,0.517825147,1.627450463,128,7
E4055,Sales,61,57,14.44231061,1,9,4,21,10,0.841842929,1.359900116,118,13
E4056,Finance,61,59,12.29255901,1,12,4,20,2,1.203680946,1.504601182,120,16
E4057,HR,53,65,12.37301163,1,8,2,20,9,0.747774718,1.495549436,118,10
E4058,HR,50,88,11.16293108,0,6,5,15,6,0.904387267,1.233255364,138,11
E4059,Support,50,53,8.700826967,0,5,6,21,11,1.133923947,2.164763898,103,11
E4060,Support,47,58,10.92489051,0,5,10,24,2,1.257873185,2.012597096,105,15
E4061,Sales,51,82,10.62724325,0,7,3,14,11,0.860049092,1.204068729,133,10
E4062,Support,42,78,11.46742813,0,5,1,23,10,0.481254028,1.844807106,120,6
E4063,Finance,47,72,11.00077647,0,8,5,14,6,1.08326324,1.166591182,119,13
E4064,HR,61,84,8.628016115,0,10,6,16,11,1.661816911,1.661816911,145,16
E4065,Operations,53,68,13.41832359,1,10,0,17,5,0.693561906,1.179055241,121,10
E4066,HR,51,64,8.418213305,-1,5,2,27,5,0.743240758,2.866785783,115,7
E4067,HR,44,71,11.18262934,0,13,8,18,8,1.723765815,1.477513556,115,21
E4068,Finance,48,77,11.54511871,1,6,6,23,1,0.956547345,1.833382412,125,12
E4069,Support,53,69,6.850176213,-1,11,3,16,4,1.783399458,2.038170809,122,14
E4070,Operations,45,77,14.68547812,2,8,6,20,8,0.892545314,1.275064735,122,14
E4071,Finance,56,75,9.876959257,0,8,8,15,5,1.47099935,1.379061891,131,16
E4072,Sales,53,72,7.019043364,-1,12,6,22,10,2.244656773,2.743469389,125,18
E4073,Engineering,52,62,10.0010915,0,8,7,24,3,1.363501067,2.181601707,114,15
E4074,HR,40,64,7.076507608,-1,5,7,18,3,1.485790713,2.22868607,104,12
E4075,Engineering,51,65,8.260128207,-1,3,4,18,1,0.755929059,1.94381758,116,7
E4076,Finance,64,79,8.201469831,-1,11,8,22,12,2.064887496,2.390922364,143,19
E4077,Finance,42,79,9.592504495,0,10,3,20,12,1.227282934,1.888127591,121,13
E4078,Finance,39,84,14.09431029,1,5,12,22,4,1.126252188,1.457502832,123,17
E4079,Engineering,50,58,10.3190946,0,9,6,11,7,1.325194331,0.971809176,108,15
E4080,Finance,52,78,10.49324482,0,9,9,18,7,1.566137351,1.566137351,130,18
E4081,Sales,55,64,8.568992535,0,12,7,13,12,1.985579979,1.358554723,119,19
E4082,Finance,51,65,10.84997626,0,10,4,25,8,1.181436966,2.109708869,116,14
E4083,Marketing,48,60,9.900743196,0,10,9,27,5,1.743000423,2.476895338,108,19
E4084,Support,52,81,9.748590826,0,13,7,28,4,1.860709029,2.604992641,133,20
E4085,Engineering,45,68,12.12120273,1,13,8,28,3,1.600463039,2.133950719,113,21
E4086,Marketing,51,70,7.175495098,-1,6,4,14,11,1.223167512,1.712434517,121,10
E4087,Finance,39,87,13.79944369,1,6,4,17,6,0.675701074,1.148691826,126,10
E4088,Sales,45,59,1.913012567,-3,4,2,25,11,2.059723349,8.582180621,104,6
E4089,HR,45,68,9.720730482,0,11,5,12,10,1.492435616,1.119326712,113,16
E4090,Operations,34,77,14.07616354,1,7,9,22,5,1.061277954,1.459257187,111,16
E4091,Support,54,78,13.62020408,1,5,6,23,11,0.752383478,1.573165454,132,11
E4092,Operations,44,75,10.47511779,0,6,7,22,12,1.132885974,1.917191648,119,13
E4093,Finance,52,77,7.570242189,-1,10,4,17,5,1.633559436,1.983607887,129,14
E4094,Support,34,74,9.599788816,0,3,4,15,4,0.660390515,1.415122533,108,7
E4095,Support,64,58,17.77443222,3,7,1,15,9,0.426111421,0.798958915,122,8
E4096,Sales,50,52,12.12628654,1,10,3,19,8,0.990379112,1.447477163,102,13
E4097,Support,48,77,4.898344583,-2,14,3,27,10,2.882164608,4.577555553,125,17
E4098,Engineering,59,69,10.24874193,0,7,5,19,8,1.066785963,1.689077775,128,12
E4099,Marketing,51,62,8.204184795,-1,10,8,16,5,1.955632183,1.738339718,113,18
E4100,Marketing,40,68,6.190204587,-1,8,5,24,11,1.808015313,3.337874425,108,13
E4101,Marketing,42,83,11.4479448,0,5,6,11,1,0.883680011,0.883680011,125,11
E4102,Engineering,44,74,7.089075697,-1,12,2,25,3,1.730729261,3.090587966,118,14
E4103,Operations,51,59,14.64494473,2,7,9,17,8,1.022694569,1.086612979,110,16
E4104,Sales,59,64,14.02323427,1,6,4,21,12,0.665635629,1.397834822,123,10
E4105,Support,55,74,7.811158544,-1,6,2,16,1,0.907939627,1.815879254,129,8
E4106,Engineering,60,84,7.623496614,-1,10,4,18,9,1.623471386,2.087320353,144,14
E4107,Marketing,44,67,12.01978408,1,7,2,25,6,0.691255703,1.92015473,111,9
E4108,Finance,49,75,13.05328946,1,9,3,17,1,0.853892609,1.209681196,124,12
E4109,HR,44,69,9.245039474,0,9,4,15,11,1.268906775,1.464123202,113,13
E4110,Support,58,76,12.93536539,1,8,5,21,12,0.932878302,1.506957257,134,13
E4111,Engineering,55,76,14.99334793,2,14,3,27,8,1.062941923,1.688201878,131,17
E4112,Engineering,55,84,10.98972528,0,6,4,20,5,0.834047467,1.668094934,139,10
E4113,Sales,54,67,6.912937455,-1,4,3,20,7,0.884627237,2.527506392,121,7
E4114,Sales,44,63,12.35655294,1,5,5,22,2,0.748696168,1.647131569,107,10
E4115,Engineering,48,78,10.42954552,0,8,5,24,10,1.137403056,2.099821026,126,13
E4116,Marketing,55,62,9.035335245,0,12,7,15,10,1.893309943,1.494718376,117,19
E4117,HR,56,72,12.25512971,1,8,1,16,7,0.678982416,1.207079851,128,9
E4118,Support,43,76,13.62119143,1,4,9,18,3,0.889120429,1.231089825,119,13
E4119,Sales,55,80,10.55803434,0,7,5,18,5,1.038238826,1.557358239,135,12
E4120,Support,48,49,3.162573456,-2,6,3,18,9,2.162124007,4.324248014,97,9
E4121,Marketing,53,74,10.35944448,0,8,7,16,5,1.320487109,1.408519582,127,15
E4122,Support,39,71,10.68088876,0,7,1,20,5,0.684879393,1.712198482,110,8
E4123,Finance,56,88,17.7577366,3,4,6,19,9,0.533113361,1.012915386,144,10
E4124,Sales,50,82,10.38886441,0,3,6,22,2,0.790245601,1.931711468,132,9
E4125,Marketing,58,70,9.486043961,0,14,4,14,6,1.716567284,1.335107887,128,18
E4126,Marketing,42,71,12.06943878,1,7,4,22,9,0.841658175,1.683316351,113,11
E4127,HR,55,73,9.09956025,0,5,7,14,2,1.188170544,1.386198968,128,12
E4128,HR,44,73,7.941620202,-1,6,4,20,2,1.118365551,2.236731101,117,10
E4129,Finance,44,66,5.216762271,-2,6,9,22,1,2.412831527,3.538819572,110,15
E4130,Marketing,51,75,8.213422982,-1,5,9,23,4,1.519522118,2.496357765,126,14
E4131,Operations,51,63,4.276613091,-2,4,4,23,2,1.516124048,4.358856638,114,8
E4132,Marketing,66,70,10.84974111,0,8,8,25,11,1.35024047,2.109750734,136,16
E4133,HR,51,60,10.64750647,0,8,4,14,8,1.030263433,1.201974005,111,12
E4134,Operations,47,72,12.08925851,1,5,9,14,5,1.069579304,1.069579304,119,14
E4135,Sales,50,73,6.906694424,-1,8,4,27,1,1.517701249,3.41482781,123,12
E4136,Sales,46,77,5.683867716,-1,11,2,21,7,1.944981641,3.14189342,123,13
E4137,Support,40,73,16.17239197,2,5,6,14,9,0.640563063,0.81526208,113,11
E4138,Engineering,55,63,9.764098355,0,6,7,16,4,1.207718433,1.486422687,118,13
E4139,HR,54,65,12.09942995,1,11,4,13,2,1.145087996,0.992409597,119,15
E4140,Engineering,53,75,10.39873277,0,12,7,17,2,1.666851955,1.491393854,128,19
E4141,Operations,47,72,12.2348312,1,7,4,15,7,0.831140181,1.133372974,119,11
E4142,HR,46,67,10.68411122,0,9,3,17,11,1.027035756,1.454967321,113,12
E4143,Finance,49,74,7.593959641,-1,9,4,12,10,1.512690371,1.396329573,123,13
E4144,Marketing,46,84,11.62546571,1,11,5,10,3,1.267279985,0.792049991,130,16
E4145,Finance,57,66,10.91179709,0,8,4,28,6,1.007404669,2.350610894,123,12
E4146,Operations,52,69,4.953019211,-2,9,3,16,11,2.015783852,2.687711803,121,12
E4147,HR,47,73,10.8836117,0,8,7,14,9,1.262242522,1.17809302,120,15
E4148,Operations,43,78,8.838661933,0,8,1,21,6,0.914758537,2.134436587,121,9
E4149,Marketing,52,75,7.99972202,-1,8,5,21,7,1.44448906,2.333405405,127,13
E4150,Sales,41,60,12.9260272,1,6,8,22,4,1.005311838,1.579775746,101,14
E4151,Sales,53,68,9.784431375,0,4,4,28,7,0.741810089,2.596335312,121,8
E4152,Operations,54,86,9.875740299,0,7,5,17,10,1.103373165,1.563111984,140,12
E4153,Engineering,48,69,10.2677489,0,16,6,20,11,1.952475175,1.774977432,117,22
E4154,HR,42,82,9.902928832,0,8,5,20,2,1.192340168,1.83436949,124,13
E4155,HR,50,68,9.706719306,0,7,6,17,8,1.214190793,1.58778796,118,13
E4156,Sales,55,54,14.36824947,1,4,6,19,2,0.650692196,1.236315173,109,10
E4157,Support,47,59,7.94726581,-1,6,5,20,5,1.229425864,2.235319753,106,11
E4158,Finance,44,78,4.789613104,-2,10,3,17,4,2.245400473,2.936292926,122,13
E4159,Support,49,78,10.13401261,0,10,0,31,4,0.898148794,2.784261262,127,10
E4160,Marketing,56,61,7.181746604,-1,13,1,18,6,1.711126081,2.200019247,117,14
E4161,Finance,52,90,6.709745487,-1,12,5,16,5,2.205001453,2.075295485,142,17
E4162,Finance,40,53,9.952797035,0,7,2,21,2,0.821707914,1.917318465,93,9
E4163,Operations,55,67,10.82403441,0,8,4,15,3,1.014882026,1.268602532,122,12
E4164,Sales,39,77,9.478971695,0,2,2,20,5,0.381716844,1.908584218,116,4
E4165,Support,47,75,8.629807561,0,10,1,13,4,1.142286586,1.349975056,122,11
E4166,Support,48,82,9.398493384,0,16,0,16,6,1.538684443,1.538684443,130,16
E4167,Sales,43,65,9.847192271,0,11,3,14,6,1.290656573,1.290656573,108,14
E4168,Support,46,77,9.991955309,0,10,3,20,9,1.18268312,1.819512492,123,13
E4169,Sales,57,58,4.623345847,-2,16,6,19,1,3.912261597,3.378771379,115,22
E4170,Operations,38,54,12.62167527,1,8,7,17,9,1.10118614,1.248010958,92,15
E4171,Engineering,48,66,5.627178949,-1,10,6,25,11,2.414300281,3.772344189,114,16
E4172,Finance,43,69,7.986751884,-1,4,2,31,4,0.667649455,3.449522186,112,6
E4173,Operations,68,46,5.337388057,-2,7,5,22,9,1.893524571,3.471461713,114,12
E4174,HR,50,58,10.50180761,0,7,5,21,12,1.043314269,1.825799971,108,12
E4175,Marketing,56,62,7.868230008,-1,5,5,13,8,1.127620731,1.46590695,118,10
E4176,Engineering,67,69,9.448526731,0,6,3,22,6,0.861365457,2.105560005,136,9
E4177,HR,49,63,7.771331062,-1,12,6,18,4,2.052140077,2.052140077,112,18
E4178,Finance,50,71,6.837679557,-1,10,7,22,12,2.169009319,2.806953237,121,17
E4179,Support,54,70,2.470019564,-3,7,6,28,4,3.746376572,8.06911877,124,13
E4180,Sales,47,64,8.225703218,-1,7,4,27,4,1.192321034,2.926606174,111,11
E4181,Finance,51,70,6.369735769,-1,12,3,14,4,2.035351126,1.899661051,121,15
E4182,Operations,40,68,11.5587634,1,9,5,19,2,1.114759436,1.512887805,108,14
E4183,Marketing,41,71,16.2427112,2,7,4,21,10,0.637950719,1.217905918,112,11
E4184,Operations,48,76,15.48977759,2,2,0,20,12,0.121287264,1.212872635,124,2
E4185,Engineering,51,65,9.756616042,0,8,9,26,2,1.580422684,2.417117047,116,17
E4186,Engineering,48,57,7.626708036,-1,5,6,17,5,1.275109805,1.970624244,105,11
E4187,Marketing,51,72,4.15045231,-2,9,0,21,11,1.747419345,4.077311804,123,9
E4188,HR,51,67,8.743696668,0,8,3,23,6,1.12893498,2.360500412,118,11
E4189,HR,53,60,7.263519797,-1,4,4,21,10,0.968110466,2.541289973,113,8
E4190,Engineering,46,76,7.78818743,-1,3,4,22,2,0.796523749,2.503360354,122,7
E4191,Engineering,59,78,5.103472115,-2,4,7,13,1,1.802252848,2.129935184,137,11
E4192,Support,69,65,12.10824699,1,6,4,24,3,0.762878515,1.830908437,134,10
E4193,Sales,45,82,11.52767955,0,8,6,21,12,1.117525392,1.676288087,127,14
E4194,Support,55,76,7.253584076,-1,7,5,15,4,1.453913826,1.817392282,131,12
E4195,Support,39,78,12.56756157,1,6,4,14,4,0.737052118,1.031872966,117,10
E4196,HR,48,70,10.17884753,0,4,2,17,9,0.536727957,1.520729213,118,6
E4197,Marketing,50,81,11.59067187,1,4,6,20,6,0.794238791,1.588477581,131,10
E4198,HR,48,77,12.32232704,1,6,4,20,3,0.750619616,1.501239231,125,10
E4199,Sales,48,75,11.09497041,0,7,4,16,10,0.909468946,1.322863922,123,11
E4200,Operations,47,69,7.538173197,-1,4,8,17,9,1.405452867,1.991058228,116,12
E4201,Engineering,59,71,13.14791534,1,6,2,11,2,0.565454331,0.777499705,130,8
E4202,Engineering,61,58,12.31822436,1,7,4,22,8,0.825935928,1.651871857,119,11
E4203,Sales,61,69,12.36207193,1,8,4,24,5,0.898064317,1.796128634,130,12
E4204,Support,52,71,6.012063444,-1,5,8,22,9,1.853947858,3.137450221,123,13
E4205,Marketing,46,69,5.599156819,-1,8,2,15,7,1.515345108,2.273017661,115,10
E4206,Engineering,45,67,14.53854018,1,6,5,16,9,0.707917209,1.029697759,112,11
E4207,Finance,56,78,8.08571986,-1,8,3,18,10,1.210691081,1.98113086,134,11
E4208,Support,58,71,10.75730657,0,6,3,24,1,0.765481443,2.041283849,129,9
E4209,Engineering,51,74,13.61910962,1,8,3,23,8,0.752439805,1.573283229,125,11
E4210,Finance,54,86,14.8989062,2,6,10,21,3,1.006358538,1.320845581,140,16
E4211,Sales,44,86,11.72241433,1,6,5,13,8,0.864615765,1.021818632,130,11
E4212,Sales,48,68,8.433679024,-1,4,3,23,2,0.742022278,2.438073199,116,7
E4213,Support,40,79,9.140070861,0,4,4,25,12,0.788949122,2.465466005,119,8
E4214,Engineering,51,90,11.11209553,0,4,2,26,2,0.495372579,2.146614509,141,6
E4215,HR,57,77,10.52466321,0,6,3,13,4,0.780933884,1.12801561,134,9
E4216,Finance,37,72,7.852023914,-1,7,7,14,10,1.581559216,1.581559216,109,14
E4217,Marketing,47,71,2.040371102,-3,9,5,25,5,4.604701048,8.222680442,118,14
E4218,Engineering,36,78,7.792316401,-1,1,6,21,12,0.796149693,2.388449078,114,7
E4219,Marketing,61,71,9.361019664,0,6,6,24,10,1.158187166,2.316374332,132,12
E4220,Engineering,57,80,9.97109934,0,12,5,23,2,1.549525665,2.096417076,137,17
E4221,HR,43,81,15.12009739,2,5,6,11,3,0.682378011,0.682378011,124,11
E4222,HR,58,69,13.20134,1,3,2,17,5,0.352079452,1.197070136,127,5
E4223,Support,51,73,8.615099948,0,5,6,26,3,1.14403387,2.704080056,124,11
E4224,Support,52,70,11.51125456,0,8,6,14,3,1.118992499,1.118992499,122,14
E4225,HR,40,63,2.00638216,-3,6,6,14,4,3.991508518,4.656759938,103,12
E4226,Operations,49,76,13.67829249,1,9,3,27,5,0.817533784,1.839451013,125,12
E4227,HR,40,69,8.510918409,-1,8,3,23,3,1.156565489,2.418273295,109,11
E4228,Sales,51,73,10.56154425,0,6,6,22,1,1.037923632,1.902859993,124,12
E4229,Sales,49,64,10.08945072,0,9,1,27,12,0.901757918,2.43474638,113,10
E4230,Operations,34,67,13.07869405,1,7,3,25,3,0.710293154,1.775732884,101,10
E4231,Finance,53,65,8.953971193,0,8,3,17,5,1.105086582,1.707861081,118,11
E4232,Marketing,52,85,12.46866122,1,5,3,25,11,0.593971433,1.856160727,137,8
E4233,Engineering,65,66,11.09400519,0,9,6,22,6,1.240283906,1.819083062,131,15
E4234,Engineering,59,94,10.36773561,0,9,2,24,8,0.967650936,2.111238406,153,11
E4235,Operations,53,64,9.675738563,0,10,2,23,7,1.124044011,2.154417689,117,12
E4236,Sales,42,81,8.471864271,-1,7,4,23,2,1.161334209,2.428244255,123,11
E4237,Support,35,65,9.502540813,0,11,6,23,5,1.618655933,2.189946262,100,17
E4238,Engineering,62,73,8.853191406,0,7,8,26,3,1.522349397,2.638738956,135,15
E4239,Sales,36,68,11.25644126,0,12,6,22,12,1.468615532,1.794974539,104,18
E4240,Finance,58,93,6.596618313,-1,7,5,15,11,1.579650248,1.97456281,151,12
E4241,Marketing,47,63,10.2162478,0,6,2,15,8,0.713251004,1.337345632,110,8
E4242,Finance,40,77,14.54865472,2,5,3,21,1,0.514513966,1.35059916,117,8
E4243,Operations,56,62,8.680271274,0,8,9,20,3,1.756149132,2.066057803,118,17
E4244,HR,58,74,11.3149551,0,7,5,12,7,0.97442499,0.97442499,132,12
E4245,HR,42,80,3.030149519,-2,5,5,26,7,2.481297518,6.451373548,122,10
E4246,HR,51,79,5.257792439,-2,6,6,18,8,1.917609144,2.876413716,130,12
E4247,Finance,43,81,9.600985863,0,5,5,22,4,0.943308493,2.075278685,124,10
E4248,Engineering,55,72,9.774125817,0,12,6,22,1,1.670669185,2.041929004,127,18
E4249,Marketing,58,57,10.12403138,0,13,6,27,11,1.708013881,2.42717762,115,19
E4250,HR,45,66,16.57238293,2,9,6,17,11,0.853612174,0.967427131,111,15
E4251,Operations,51,69,8.251247933,-1,6,1,16,1,0.756654675,1.7294964,120,7
E4252,Operations,55,79,10.25323883,0,9,5,21,1,1.244086276,1.866129415,134,14
E4253,HR,53,79,7.850856841,-1,5,7,21,7,1.355800937,2.37265164,132,12
E4254,HR,49,69,12.21067726,1,6,5,20,1,0.832659808,1.513926925,118,11
E4255,Marketing,60,83,6.548919271,-1,8,6,14,10,1.854570104,1.854570104,143,14
E4256,HR,54,60,7.902984429,-1,5,10,23,5,1.684828286,2.583403372,114,15
E4257,Marketing,49,80,7.295594047,-1,9,7,27,11,1.928734688,3.254739787,129,16
E4258,Operations,46,76,12.47110407,1,13,6,18,12,1.410426339,1.336193374,122,19
E4259,HR,56,72,10.37796125,0,11,2,24,8,1.142559701,2.109340986,128,13
E4260,Finance,55,65,10.85048619,0,8,7,25,2,1.265770852,2.109618087,120,15
E4261,Support,51,74,9.41824286,0,6,4,20,4,0.95985476,1.91970952,125,10
E4262,Finance,42,72,13.62779557,1,9,2,21,6,0.751993009,1.435623017,114,11
E4263,Operations,41,69,9.53521478,0,6,4,14,7,0.949197545,1.328876562,110,10
E4264,Marketing,51,82,15.89595212,2,13,5,23,5,1.065343928,1.361272797,133,18
E4265,Finance,41,63,13.8083353,1,9,5,12,8,0.945413493,0.810354422,104,14
E4266,Marketing,54,73,5.572483312,-1,7,5,11,10,1.825793909,1.673644417,127,12
E4267,Finance,44,74,11.91560522,1,6,8,24,3,1.083960044,1.858217217,118,14
E4268,Finance,48,69,13.8034543,1,7,7,19,7,0.945725215,1.283484221,117,14
E4269,Marketing,42,66,8.776793565,0,3,6,19,12,0.920547206,1.943377435,108,9
E4270,Engineering,56,66,11.23436919,0,14,7,17,11,1.716475911,1.389528118,122,21
E4271,Finance,47,63,5.566286852,-1,8,4,20,7,1.827516871,3.045861451,110,12
E4272,HR,45,55,7.011954456,-1,4,7,21,2,1.372948394,2.621083297,100,11
E4273,Support,39,64,9.245095687,0,5,8,20,1,1.268899813,1.952153558,103,13
E4274,Operations,54,53,5.936612254,-1,7,4,24,2,1.585788508,3.4599022,107,11
E4275,Engineering,47,69,10.16558197,0,8,8,21,10,1.432975016,1.880779708,116,16
E4276,Marketing,46,64,11.95114458,1,4,3,25,11,0.540492769,1.93033132,110,7
E4277,Engineering,47,66,7.252259777,-1,7,6,21,3,1.575326074,2.544757505,113,13
E4278,Sales,56,77,5.978440467,-1,8,5,19,12,1.862880404,2.72267136,133,13
E4279,Sales,45,89,5.263397834,-2,7,3,15,7,1.596577491,2.394866237,134,10
E4280,Finance,57,79,13.6372347,1,5,5,18,1,0.683189154,1.229740478,136,10
E4281,Finance,56,74,4.773811517,-2,9,6,16,10,2.597937248,2.771133064,130,15
E4282,HR,76,79,10.88738535,0,5,3,20,1,0.672982306,1.682455764,155,8
E4283,Support,47,78,13.91765241,1,9,9,26,9,1.206624173,1.742901583,125,18
E4284,Operations,47,65,7.066086573,-1,3,5,14,5,0.99180686,1.735662006,112,8
E4285,Engineering,58,52,7.468113887,-1,12,4,12,9,1.889440814,1.417080611,110,16
E4286,Sales,29,56,10.52702855,0,7,4,19,8,0.954278889,1.648299899,85,11
E4287,Finance,47,75,10.72201234,0,12,8,15,9,1.706191686,1.279643765,122,20
E4288,Operations,50,71,8.504748579,-1,8,7,25,11,1.578158525,2.630264209,121,15
E4289,Engineering,51,70,9.10885712,0,5,8,24,9,1.286000964,2.374155626,121,13
E4290,Finance,53,63,10.27255887,0,17,5,20,5,1.951642059,1.774220054,116,22
E4291,Finance,63,62,8.787800192,0,6,4,22,10,1.021680031,2.247696067,125,10
E4292,Sales,50,60,8.888753185,0,8,2,14,9,1.011249832,1.415749765,110,10
E4293,Sales,48,62,15.82719179,2,3,4,22,12,0.415993357,1.307407693,110,7
E4294,Finance,58,68,13.04028964,1,8,3,22,12,0.783459621,1.566919242,126,11
E4295,Marketing,51,55,13.27592185,1,6,5,24,1,0.770528174,1.681152381,106,11
E4296,Finance,45,65,8.976845257,0,7,5,22,2,1.202785018,2.205105866,110,12
E4297,Operations,54,83,4.843712138,-2,5,7,14,4,2.05348924,2.395737447,137,12
E4298,Finance,57,63,17.42826522,2,5,2,16,12,0.379851273,0.868231481,120,7
E4299,HR,49,66,8.149650627,-1,11,5,20,7,1.74870065,2.185875813,115,16
E4300,Support,47,73,10.92782393,0,9,6,15,11,1.257563835,1.257563835,120,15
E4301,HR,54,62,12.35114124,1,7,4,21,4,0.823899606,1.572899247,116,11
E4302,HR,50,69,8.258603407,-1,13,5,20,7,1.944137707,2.160153008,119,18
E4303,Marketing,47,75,12.70442443,1,7,15,28,12,1.605320975,2.043135787,122,22
E4304,Marketing,46,67,10.02703367,0,7,5,26,9,1.088234639,2.357841718,113,12
E4305,Finance,38,53,9.209421233,0,6,4,16,9,0.979487453,1.567179925,91,10
E4306,HR,49,89,8.257318218,-1,4,5,19,10,0.972203805,2.052430256,138,9
E4307,Marketing,45,69,7.010221845,-1,8,4,17,2,1.49808585,2.122288287,114,12
E4308,Sales,54,78,4.411547898,-2,4,9,25,4,2.402270154,4.619750296,132,13
E4309,Finance,56,75,18.44131965,3,5,3,23,2,0.4114947,1.183047263,131,8
E4310,Operations,51,49,14.37202022,1,8,2,25,8,0.650532582,1.626331454,100,10
E4311,Support,51,64,10.30882004,0,4,6,16,10,0.884265553,1.414824884,115,10
E4312,Engineering,35,81,14.68005242,2,6,4,17,6,0.63775297,1.084180049,116,10
E4313,Finance,51,73,14.28761556,1,6,2,17,5,0.523299397,1.112011218,124,8
E4314,Engineering,58,75,11.78962149,1,7,7,19,11,1.094637555,1.485579539,133,14
E4315,HR,57,75,8.965007261,0,4,8,21,7,1.204213874,2.10737428,132,12
E4316,Support,48,69,13.22242857,1,9,8,26,3,1.195295158,1.828098476,117,17
E4317,Engineering,51,77,12.72583665,1,8,5,18,7,0.947118951,1.31139547,128,13
E4318,HR,43,69,12.37350152,1,15,2,22,8,1.271170454,1.645044117,112,17
E4319,Sales,51,80,8.988343773,0,7,1,19,5,0.800933586,1.902217268,131,8
E4320,Engineering,63,78,11.13682428,0,5,5,28,2,0.823938764,2.30702854,141,10
E4321,Support,37,62,10.82022296,0,2,4,13,7,0.507604638,1.099810049,99,6
E4322,Finance,48,68,8.857846556,0,6,3,13,12,0.912978301,1.318746435,116,9
E4323,HR,49,82,11.10991966,0,11,6,21,8,1.403807826,1.73411555,131,17
E4324,Finance,47,67,13.7583462,1,7,7,11,10,0.948615773,0.745340965,114,14
E4325,Support,57,75,14.57668336,2,6,8,27,1,0.898779264,1.733360009,132,14
E4326,Marketing,42,77,11.49833152,0,8,5,13,11,1.040138836,1.040138836,119,13
E4327,HR,47,68,9.501897948,0,11,3,11,6,1.333092368,1.047429717,115,14
E4328,Engineering,39,72,12.56413921,1,7,7,30,7,1.032133318,2.211714252,111,14
E4329,HR,50,70,7.38375288,-1,7,7,13,5,1.669896549,1.550618224,120,14
E4330,Finance,51,60,8.868700294,0,1,11,23,3,1.215965592,2.330600719,111,12
E4331,Sales,53,61,13.8254979,1,12,2,24,2,0.944319044,1.618832647,114,14
E4332,HR,38,80,15.6153017,2,6,5,19,11,0.662040341,1.143524225,118,11
E4333,Engineering,58,67,13.41972561,1,7,4,17,11,0.762843919,1.178940603,125,11
E4334,Marketing,38,69,9.755220729,0,4,8,22,12,1.115737213,2.045518224,107,12
E4335,Operations,43,64,3.4309906,-2,9,5,20,5,3.159564365,4.513663378,107,14
E4336,Sales,64,76,12.35192656,1,10,2,27,8,0.898746705,2.022180086,140,12
E4337,Marketing,54,69,11.57103221,1,5,5,27,10,0.795479626,2.14779499,123,10
E4338,HR,45,69,11.65738721,1,7,9,14,6,1.264083948,1.106073454,114,16
E4339,Finance,44,75,5.69784258,-1,4,11,15,5,2.239527104,2.239527104,119,15
E4340,Support,58,78,9.0081803,0,9,5,26,10,1.398855694,2.597874861,136,14
E4341,Finance,41,70,15.59590186,2,11,6,22,9,1.024349273,1.32562847,111,17
E4342,Engineering,43,70,6.928376575,-1,5,2,20,3,0.882904581,2.522584518,113,7
E4343,Finance,53,58,11.73512736,1,7,4,26,8,0.863752649,2.041597171,111,11
E4344,Sales,48,64,8.03135418,-1,6,9,25,12,1.660880495,2.768134158,112,15
E4345,Finance,64,62,11.52244066,0,7,0,14,8,0.55899646,1.11799292,126,7
E4346,Engineering,48,62,9.403110233,0,13,6,22,8,1.826376879,2.114752176,110,19
E4347,Operations,49,71,13.61949132,1,2,12,21,3,0.957625659,1.436438488,120,14
E4348,HR,40,72,10.12377412,0,10,4,11,11,1.258565649,0.98887301,112,14
E4349,Support,50,76,12.98410565,1,8,5,15,4,0.929626844,1.072646359,126,13
E4350,HR,58,55,16.33377335,2,7,6,17,9,0.749980961,0.980744334,113,13
E4351,Finance,65,65,12.95827004,1,5,4,12,1,0.644779043,0.859705391,130,9
E4352,Marketing,43,71,11.72971259,1,12,2,22,3,1.099789167,1.728240119,114,14
E4353,HR,45,83,13.47192678,1,7,5,27,7,0.829191592,1.865681081,128,12
E4354,Operations,54,69,11.68792328,1,9,3,23,1,0.945781255,1.812747406,123,12
E4355,Finance,49,57,8.176021385,-1,10,2,20,5,1.307756324,2.179593874,106,12
E4356,Support,71,67,7.462351037,-1,12,3,19,2,1.772557051,2.245238931,138,15
E4357,Engineering,48,86,12.0704307,1,10,6,18,7,1.224137166,1.377154312,134,16
E4358,Operations,63,66,8.124089214,-1,6,5,18,8,1.205599786,1.972799649,129,11
E4359,Finance,42,65,7.832998934,-1,7,9,25,9,1.811389328,2.830295824,107,16
E4360,Operations,47,78,9.428181808,0,9,8,14,7,1.630197892,1.342515911,125,17
E4361,HR,55,80,4.821666654,-2,9,12,16,2,3.607214437,2.748353856,135,21
E4362,Support,51,51,8.038343244,-1,10,6,19,10,1.770235935,2.102155172,102,16
E4363,Engineering,49,89,7.793252456,-1,10,6,21,3,1.819577009,2.388194824,138,16
E4364,Finance,58,64,17.38588955,2,11,7,19,9,0.979011647,1.033401182,122,18
E4365,Sales,36,75,12.25333505,1,7,6,23,10,0.980885185,1.73541225,111,13
E4366,Engineering,61,76,8.735932444,0,5,3,22,9,0.821698389,2.259670569,137,8
E4367,Sales,58,58,7.699381621,-1,9,5,15,3,1.609309789,1.724260488,116,14
E4368,Operations,51,64,2.686172551,-2,5,4,19,3,2.441556893,5.154397885,115,9
E4369,Marketing,44,57,5.606020715,-1,5,5,24,2,1.513770609,3.633049462,101,10
E4370,Engineering,54,70,5.019654602,-2,3,7,20,3,1.661224881,3.322449762,124,10
E4371,Operations,49,64,7.069932904,-1,11,9,27,9,2.478335352,3.345752725,113,20
E4372,Sales,41,62,9.968947068,0,10,7,23,5,1.549829705,2.096828425,103,17
E4373,HR,55,73,9.436472517,0,11,3,24,5,1.34144942,2.299627576,128,14
E4374,HR,44,68,7.321116202,-1,10,6,15,6,1.92281896,1.802642775,112,16
E4375,Marketing,49,64,9.847290502,0,4,6,22,6,0.921889203,2.028156247,113,10
E4376,Engineering,49,80,5.700558569,-1,7,3,28,8,1.492412893,4.178756101,129,10
E4377,Engineering,54,63,11.33253497,0,10,5,22,6,1.216294949,1.783899259,117,15
E4378,Engineering,47,89,12.29190792,1,8,5,20,8,0.978038674,1.504674884,136,13
E4379,Operations,51,66,11.47865474,0,9,3,9,12,0.96164212,0.72123159,117,12
E4380,Support,53,85,13.2817443,1,9,5,24,11,0.980272416,1.680467,138,14
E4381,Support,49,72,5.447937184,-2,7,4,20,9,1.705971954,3.10176719,121,11
E4382,Marketing,53,61,10.11935153,0,8,4,10,5,1.079199625,0.89933302,114,12
E4383,Engineering,43,85,7.141652305,-1,7,3,18,2,1.228251911,2.210853439,128,10
E4384,Operations,64,70,6.544530018,-1,5,9,22,12,1.855649055,2.916019944,134,14
E4385,HR,62,59,5.756173755,-1,9,11,20,5,2.960255423,2.960255423,121,20
E4386,Sales,44,75,17.43532955,2,8,3,20,3,0.59668041,1.084873473,119,11
E4387,Operations,51,82,12.73394632,1,11,7,18,10,1.310621112,1.310621112,133,18
E4388,Support,43,70,14.86755398,2,4,5,20,6,0.567195172,1.260433715,113,9
E4389,Support,53,69,11.05828441,0,8,10,12,5,1.492749663,0.995166442,122,18
E4390,HR,63,84,7.516365372,-1,8,7,27,10,1.761314756,3.170366561,147,15
E4391,HR,39,58,12.01559834,1,10,6,13,3,1.229294235,0.998801566,97,16
E4392,Sales,54,61,17.02809951,2,5,6,21,12,0.610158602,1.164848241,115,11
E4393,HR,57,81,11.57400883,1,6,4,23,7,0.795291314,1.829170021,138,10
E4394,Marketing,44,72,9.662329503,0,14,6,18,6,1.875762702,1.688186432,116,20
E4395,Sales,48,70,10.81477793,0,8,5,20,5,1.100316915,1.692795254,118,13
E4396,HR,53,77,13.34625052,1,7,10,19,9,1.18497861,1.324387858,130,17
E4397,Finance,52,81,9.95183979,0,10,3,24,11,1.187015173,2.191412627,133,13
E4398,Operations,56,74,9.649763064,0,5,7,18,1,1.126785632,1.690178447,130,12
E4399,HR,59,74,7.967150924,-1,9,5,20,4,1.561253972,2.230362818,133,14
E4400,Marketing,57,72,11.06416069,0,11,2,21,6,1.077571854,1.740692994,129,13
E4401,Engineering,46,67,6.192679671,-1,5,4,16,1,1.251272184,2.224483883,113,9
E4402,HR,53,74,8.845849313,0,5,4,22,9,0.914090772,2.234444109,127,9
E4403,Support,50,65,9.614561972,0,5,7,24,10,1.130522393,2.261044786,115,12
E4404,Support,59,74,6.820037175,-1,7,4,22,1,1.406642929,2.813285859,133,11
E4405,Support,54,87,9.932343381,0,9,7,17,5,1.46354715,1.555018847,141,16
E4406,Engineering,55,68,12.86038454,1,11,6,16,10,1.226517197,1.154369127,123,17
E4407,Support,48,62,14.35155765,1,14,6,23,1,1.302799394,1.498219303,110,20
E4408,Finance,64,56,9.289958859,0,14,9,14,9,2.235188723,1.360549657,120,23
E4409,HR,51,74,8.63494363,0,4,5,15,1,0.934099912,1.556833187,125,9
E4410,Support,47,60,9.217336198,0,8,3,14,3,1.076601551,1.370220156,107,11
E4411,Sales,48,82,11.87716267,1,8,7,21,1,1.164852879,1.63079403,130,15
E4412,Engineering,52,73,8.128465953,-1,8,2,19,1,1.095474316,2.081401201,125,10
E4413,Finance,49,72,8.12410156,-1,4,9,24,8,1.424797819,2.630395973,121,13
E4414,Sales,54,61,10.81309892,0,5,9,17,6,1.185125097,1.439080475,115,14
E4415,Sales,60,65,11.55640154,1,10,2,21,11,0.955687819,1.672453683,125,12
E4416,Sales,66,78,10.60262578,0,9,3,23,7,1.034248645,1.982309903,144,12
E4417,Sales,56,76,10.37181763,0,9,6,22,3,1.319050348,1.934607177,132,15
E4418,HR,43,59,8.546671225,0,9,6,17,4,1.5712283,1.780725407,102,15
E4419,Support,55,59,10.0610322,0,15,6,22,10,1.89855699,1.988964466,114,21
E4420,Operations,54,64,2.850077504,-2,8,9,20,2,4.415495528,5.194700621,118,17
E4421,HR,46,89,14.64933841,2,7,7,22,5,0.894606509,1.405810228,135,14
E4422,HR,55,62,10.48336004,0,7,1,25,1,0.696660209,2.177063152,117,8
E4423,Finance,55,80,16.31191842,2,15,7,22,10,1.270800813,1.270800813,135,22
E4424,Finance,56,76,13.86588543,1,8,7,24,7,1.009021633,1.614434613,132,15
E4425,Support,43,84,7.554703978,-1,6,3,17,2,1.052052768,1.987210784,127,9
E4426,Operations,51,76,8.90769986,0,14,2,20,11,1.614905601,2.018632002,127,16
E4427,Finance,61,51,6.693343862,-1,9,4,23,7,1.689772384,2.989597295,112,13
E4428,Support,48,70,7.991270513,-1,6,5,19,12,1.223408859,2.113160757,118,11
E4429,Support,48,65,5.308478321,-2,5,9,18,12,2.219235652,2.853302981,113,14
E4430,Marketing,46,69,7.229151102,-1,11,5,14,8,1.944307475,1.701269041,115,16
E4431,Operations,48,65,6.894694923,-1,13,1,21,7,1.773342749,2.660014124,113,14
E4432,Finance,43,73,12.64458856,1,13,4,18,4,1.245915179,1.319204308,116,17
E4433,Operations,53,65,5.138326445,-2,7,5,20,8,1.954930241,3.258217069,118,12
E4434,HR,49,67,16.67762198,2,9,2,21,11,0.622255641,1.187942587,116,11
E4435,HR,53,75,9.034721297,0,7,8,19,9,1.494809826,1.89342578,128,15
E4436,Operations,45,66,14.04136355,1,8,7,19,3,0.997250013,1.26318335,111,15
E4437,Marketing,52,69,7.107471193,-1,8,7,22,2,1.850145334,2.71354649,121,15
E4438,Marketing,54,79,12.334453,1,8,4,16,10,0.899924429,1.199899239,133,12
E4439,Operations,50,73,5.594665535,-1,7,7,23,5,2.122927983,3.4876674,123,14
E4440,Finance,52,76,5.577854334,-1,5,7,17,4,1.824303092,2.58442938,128,12
E4441,Engineering,46,78,13.28348006,1,7,4,17,8,0.770120444,1.19018614,124,11
E4442,Marketing,43,74,9.634223965,0,4,5,37,10,0.846324098,3.479332401,117,9
E4443,Sales,34,76,9.40533496,0,7,3,14,11,0.961045467,1.345463654,110,10
E4444,HR,50,67,6.990156403,-1,7,7,15,6,1.75215594,1.877309935,117,14
E4445,Operations,48,66,7.386299463,-1,10,4,13,6,1.669389468,1.550147363,114,14
E4446,Sales,43,81,5.211965407,-2,6,6,18,3,1.931755767,2.897633651,124,12
E4447,Operations,51,73,8.430080735,-1,9,9,27,5,1.908785355,2.863178032,124,18
E4448,Support,57,66,10.76867494,0,8,7,25,5,1.274569999,2.124283331,123,15
E4449,HR,52,76,10.23769329,0,7,3,18,7,0.889862336,1.601752205,128,10
E4450,HR,43,63,10.26928668,0,7,5,22,7,1.064841134,1.952208745,106,12
E4451,Marketing,44,60,3.840914193,-2,11,3,21,8,2.892015731,4.338023597,104,14
E4452,Marketing,65,60,10.5901727,0,13,6,17,5,1.639319834,1.466759852,125,19
E4453,Sales,53,56,9.043497339,0,8,6,21,5,1.393936746,2.090905119,109,14
E4454,Support,59,62,7.642027563,-1,9,5,23,5,1.619990205,2.661412479,121,14
E4455,Operations,48,73,6.294628087,-1,5,12,22,4,2.330482075,3.015917979,121,17
E4456,Support,54,63,11.9918402,1,9,3,19,6,0.923656681,1.462456412,117,12
E4457,HR,50,62,3.621712672,-2,4,8,19,10,2.596440076,4.11103012,112,12
E4458,Sales,53,64,6.299843223,-1,7,2,23,7,1.232903191,3.150752598,117,9
E4459,Engineering,53,57,10.44139562,0,12,3,27,3,1.311028872,2.35985197,110,15
E4460,Sales,54,70,8.457706219,-1,6,7,21,11,1.374540475,2.220411537,124,13
E4461,Finance,43,63,11.13458867,0,10,3,13,2,1.071317731,1.071317731,106,13
E4462,Sales,43,67,10.28910411,0,12,5,22,3,1.505876803,1.948781745,110,17
E4463,Support,43,74,7.962330665,-1,7,7,16,7,1.56209367,1.785249909,117,14
E4464,Finance,54,74,4.921606418,-2,3,3,29,2,1.013238567,4.897319739,128,6
E4465,Finance,36,61,12.25944599,1,11,8,24,2,1.432940713,1.810030375,97,19
E4466,Finance,59,80,9.481289454,0,5,1,18,12,0.57244865,1.717345951,139,6
E4467,Engineering,47,59,6.053983807,-1,10,2,18,6,1.701166366,2.551749549,106,12
E4468,Sales,33,65,3.702002429,-2,11,6,24,9,3.615480906,5.104208337,98,17
E4469,Support,53,73,10.9976032,0,14,6,24,3,1.666999621,2.000399546,126,20
E4470,Sales,55,75,8.093985601,-1,11,1,22,4,1.319553442,2.41918131,130,12
E4471,Engineering,64,66,6.563123444,-1,12,6,21,5,2.379969087,2.776630602,130,18
E4472,HR,47,78,13.53421339,1,6,6,24,11,0.825638077,1.651276154,125,12
E4473,Marketing,54,86,4.375106064,-2,10,8,25,9,3.348771128,4.651071012,140,18
E4474,Support,61,80,9.250637144,0,9,3,20,7,1.170658939,1.951098231,141,12
E4475,Support,41,60,12.17414035,1,8,6,13,1,1.062687935,0.986781654,101,14
E4476,Sales,52,54,11.46582654,0,15,5,20,5,1.604386194,1.604386194,106,20
E4477,Marketing,48,60,6.089615328,-1,5,4,17,5,1.269462387,2.397873398,108,9
E4478,Operations,55,44,13.95199674,1,5,7,30,8,0.802568393,2.006420983,99,12
E4479,Operations,50,88,14.2596284,1,7,2,24,5,0.589791557,1.572777486,138,9
E4480,Engineering,67,71,13.07325338,1,10,4,21,11,0.994794851,1.492192277,138,14
E4481,Operations,48,68,7.399992047,-1,6,10,14,6,1.904763708,1.666668245,116,16
E4482,Support,52,68,9.324061307,0,9,3,16,3,1.162333276,1.549777701,120,12
E4483,Operations,53,64,13.77420206,1,12,11,28,4,1.556767662,1.895195415,117,23
E4484,HR,52,71,11.33234535,0,10,4,26,2,1.135226074,2.108276995,123,14
E4485,HR,53,75,8.085392243,-1,10,5,23,6,1.651001916,2.531536271,128,15
E4486,HR,48,65,9.361770464,0,9,5,27,9,1.351120453,2.605732302,113,14
E4487,Operations,48,60,5.425705374,-2,5,3,20,7,1.244999503,3.112498758,108,8
E4488,Engineering,42,55,13.44761615,1,8,4,19,7,0.830586851,1.315095847,97,12
E4489,Finance,61,56,9.694223384,0,5,7,22,5,1.122101117,2.05718538,117,12
E4490,Finance,73,61,15.22897927,2,12,8,18,10,1.232363396,1.109127056,134,20
E4491,Marketing,42,77,4.522079643,-2,5,4,27,7,1.629820753,4.889462258,119,9
E4492,Finance,54,75,7.085483062,-1,7,2,15,1,1.113106036,1.855176727,129,9
E4493,Finance,47,64,9.841578308,0,9,5,15,10,1.291324898,1.38356239,111,14
E4494,HR,53,67,16.78405345,2,7,6,20,2,0.730991955,1.124603008,120,13
E4495,HR,40,77,10.23303318,0,8,4,20,7,1.068277803,1.780463005,117,12
E4496,Operations,43,78,7.720602844,-1,7,4,22,7,1.261380686,2.522761372,121,11
E4497,Marketing,60,61,10.05332655,0,9,3,16,2,1.085646022,1.447528029,121,12
E4498,Sales,44,66,7.97252999,-1,1,9,26,3,1.114512853,2.897733418,110,10
E4499,Support,60,79,12.83895186,1,2,3,25,12,0.361299038,1.806495192,139,5
E4500,Marketing,47,67,12.58403331,1,8,5,14,3,0.957005898,1.030621737,114,13
E4501,Marketing,40,74,14.8307512,2,9,3,16,10,0.758018356,1.010691142,114,12
E4502,Engineering,59,75,5.073541355,-2,6,4,19,3,1.646485866,3.128323146,134,10
E4503,Operations,59,67,4.584802091,-2,6,4,14,7,1.790573746,2.506803244,126,10
E4504,Engineering,54,60,9.301246025,0,5,8,14,5,1.261983256,1.359058891,114,13
E4505,Marketing,48,68,12.44745506,1,12,1,23,10,0.96672567,1.710360801,116,13
E4506,Marketing,61,64,13.0739054,1,5,3,23,1,0.568427865,1.634230112,125,8
E4507,Marketing,52,77,10.72020883,0,6,8,17,4,1.194517965,1.4504861,129,14
E4508,Finance,45,57,12.44212443,1,8,4,25,9,0.892716033,1.85982507,102,12
E4509,Support,54,89,14.54495804,1,11,1,21,12,0.77195448,1.35092034,143,12
E4510,Support,49,78,7.636708286,-1,11,2,27,9,1.50520309,3.126191033,127,13
E4511,Engineering,47,96,14.40130796,1,7,0,16,8,0.454506852,1.038872805,143,7
E4512,Marketing,47,77,14.49272162,1,15,9,21,7,1.549114519,1.355475204,124,24
E4513,Support,50,66,8.344114153,-1,5,8,29,7,1.391250127,3.103557975,116,13
E4514,HR,71,61,7.152546703,-1,7,8,21,6,1.839915863,2.575882208,132,15
E4515,Support,59,66,12.27352827,1,8,4,15,8,0.90405503,1.130068788,125,12
E4516,Operations,52,62,15.97198343,2,7,3,12,11,0.589206326,0.707047591,114,10
E4517,Operations,51,76,7.46661476,-1,3,2,19,3,0.590554802,2.244108246,127,5
E4518,Support,47,85,15.76096979,2,5,2,16,10,0.417636932,0.954598702,132,7
E4519,HR,59,74,7.118573796,-1,9,2,16,12,1.354917782,1.970789501,133,11
E4520,Operations,42,74,9.340125285,0,9,5,21,7,1.353948779,2.030923168,116,14
E4521,Finance,43,73,6.611628583,-1,8,5,20,12,1.707913078,2.627558581,116,13
E4522,Support,51,80,11.29225053,0,7,7,27,10,1.138928951,2.196505834,131,14
E4523,Finance,37,75,10.40696587,0,3,5,23,3,0.701325847,2.01631181,112,8
E4524,Support,57,68,10.14901325,0,15,3,16,10,1.614492655,1.435104582,125,18
E4525,Sales,41,58,8.116950159,-1,9,3,15,1,1.316229637,1.645287047,99,12
E4526,Sales,50,85,8.718206674,0,12,3,20,10,1.543494649,2.057992865,135,15
E4527,Sales,35,67,9.80056733,0,11,6,25,10,1.573991391,2.314693223,102,17
E4528,Operations,46,72,9.216862279,0,12,9,20,5,2.055425573,1.957548164,118,21
E4529,Finance,48,70,9.871937557,0,10,5,16,6,1.379698873,1.471678798,118,15
E4530,Finance,49,90,5.510440394,-2,5,11,25,8,2.457591043,3.839986005,139,16
E4531,Finance,59,61,3.54739538,-2,8,2,10,9,2.199061037,2.199061037,120,10
E4532,HR,51,85,11.04091618,0,8,7,23,11,1.245752381,1.910153651,136,15
E4533,Finance,50,70,11.13878418,0,7,5,23,7,0.988566879,1.894753186,120,12
E4534,HR,47,73,10.70302511,0,6,7,15,2,1.110823901,1.281719885,120,13
E4535,Sales,56,73,11.58327907,1,8,4,19,10,0.953646497,1.509940287,129,12
E4536,Sales,59,73,8.641860053,0,8,4,25,6,1.244573136,2.592860699,132,12
E4537,Operations,52,65,8.944904509,0,11,7,21,2,1.80997213,2.111634152,117,18
E4538,Support,45,67,8.565664882,0,6,4,12,11,1.045405638,1.254486766,112,10
E4539,Sales,64,74,4.569637629,-2,12,4,24,11,2.87271831,4.309077466,138,16
E4540,Support,60,82,11.7242891,1,7,4,16,1,0.864488374,1.257437635,142,11
E4541,Support,46,72,12.35602503,1,6,7,27,9,0.973343489,2.021559554,118,13
E4542,Operations,46,62,12.79556445,1,12,7,22,12,1.377254266,1.594715466,108,19
E4543,Marketing,39,74,9.067643272,0,6,8,23,4,1.39059357,2.28454658,113,14
E4544,Marketing,59,58,7.847412501,-1,5,4,20,11,1.017246568,2.260547928,117,9
E4545,Engineering,42,63,8.588475384,0,11,4,26,2,1.564378006,2.711588543,105,15
E4546,Operations,48,80,8.453495234,-1,9,5,26,11,1.480933734,2.750305507,128,14
E4547,Engineering,55,68,3.989603671,-2,9,8,23,4,3.407084234,4.609584551,123,17
E4548,Engineering,51,73,10.89142657,0,9,7,14,7,1.345507195,1.177318795,124,16
E4549,Marketing,43,68,12.53098751,1,9,5,11,6,1.034662104,0.812948796,111,14
E4550,Operations,48,59,10.64985218,0,4,9,13,4,1.115893987,1.115893987,107,13
E4551,Marketing,48,62,10.06764494,0,8,6,16,5,1.264948422,1.445655339,110,14
E4552,Engineering,53,66,8.118237859,-1,4,7,19,12,1.206373443,2.083735947,119,11
E4553,Operations,51,53,12.2860781,1,11,2,17,9,0.97846783,1.279534854,104,13
E4554,Engineering,64,61,9.736985603,0,9,9,24,5,1.676448183,2.235264243,125,18
E4555,Finance,47,67,6.343797644,-1,5,4,30,10,1.225523964,4.08507988,114,9
E4556,Support,59,77,13.96952231,1,6,3,20,8,0.60122159,1.336047977,136,9
E4557,Operations,46,62,11.94002261,1,7,3,12,12,0.772796177,0.927355412,108,10
E4558,Operations,54,85,14.9647427,2,8,6,11,12,0.876932392,0.689018308,139,14
E4559,Support,46,70,13.48843133,1,8,11,19,5,1.311391107,1.311391107,116,19
E4560,Engineering,67,67,8.13097358,-1,9,5,18,3,1.533242855,1.971312242,134,14
E4561,Finance,39,66,9.144730513,0,11,9,28,9,1.971466859,2.760053603,105,20
E4562,HR,57,75,13.03463414,1,7,8,18,12,1.068784541,1.282541449,132,15
E4563,Support,64,82,6.474181316,-1,5,9,19,11,1.873114848,2.542084437,146,14
E4564,Marketing,47,67,14.96767923,2,10,2,12,4,0.751518103,0.751518103,114,12
E4565,Engineering,59,76,10.98241654,0,9,1,15,11,0.834556199,1.251834298,135,10
E4566,Support,48,73,12.48387491,1,6,6,10,9,0.889951893,0.741626577,121,12
E4567,Support,60,67,10.96895449,0,7,8,17,1,1.253242295,1.420341268,127,15
E4568,Operations,44,64,10.16016504,0,9,5,22,9,1.254461735,1.971297012,108,14
E4569,Marketing,46,61,9.12893806,0,9,7,20,1,1.579632525,1.974540656,107,16
E4570,Marketing,54,64,9.560488603,0,4,7,26,8,1.041618472,2.462007297,118,11
E4571,Marketing,63,60,1.987778916,-3,3,8,24,2,3.681664644,8.03272286,123,11
E4572,Support,45,68,11.68827943,1,13,3,26,4,1.261006277,2.0491352,113,16
E4573,HR,56,65,16.53619983,2,9,1,17,12,0.570248976,0.96942326,121,10
E4574,Sales,57,70,7.512428495,-1,10,3,27,6,1.527178761,3.171832811,127,13
E4575,Engineering,63,74,5.595643336,-1,4,2,21,3,0.909691397,3.183919889,137,6
E4576,Sales,40,74,14.70630177,2,4,6,15,10,0.636687117,0.955030676,114,10
E4577,Support,43,63,11.13277068,0,9,3,21,12,0.989056854,1.730849495,106,12
E4578,Sales,52,61,12.71398717,1,8,3,19,6,0.802100794,1.385446826,113,11
E4579,Support,52,81,11.50990038,0,10,5,21,9,1.199050316,1.678670443,133,15
E4580,Sales,60,70,7.217986218,-1,10,5,19,12,1.825264682,2.31200193,130,15
E4581,Marketing,49,66,12.72656801,1,6,9,18,11,1.092771331,1.311325597,115,15
E4582,Finance,45,56,8.521036432,-1,7,2,20,4,0.94527524,2.100611645,101,9
E4583,Marketing,49,87,7.522078107,-1,10,1,21,3,1.290764983,2.464187694,136,11
E4584,Marketing,58,68,11.91529825,1,7,4,15,1,0.851703134,1.161413365,126,11
E4585,Operations,57,65,10.51832425,0,5,5,21,3,0.868181845,1.823181874,122,10
E4586,Operations,58,71,11.23940499,0,8,6,24,12,1.143846454,1.960879636,129,14
E4587,Sales,43,71,11.13239426,0,9,6,18,7,1.236359426,1.483631311,114,15
E4588,Support,51,68,12.49089607,1,8,1,21,4,0.667116547,1.556605276,119,9
E4589,Marketing,43,75,13.8901387,1,6,10,25,11,1.074536667,1.678963542,118,16
E4590,Sales,50,74,10.6346144,0,11,3,16,10,1.203305887,1.375206728,124,14
E4591,Operations,54,74,14.3337954,1,5,6,27,11,0.717369687,1.760816504,128,11
E4592,Finance,40,56,13.39507285,1,4,4,21,12,0.555745711,1.458832492,96,8
E4593,Engineering,56,88,12.21933018,1,9,3,26,9,0.907761576,1.966816748,144,12
E4594,Sales,58,57,8.275729546,-1,7,3,20,7,1.078082317,2.156164634,115,10
E4595,Finance,41,62,12.93911267,1,12,3,23,3,1.07610867,1.650033295,103,15
E4596,Engineering,62,93,11.2827249,0,3,1,26,9,0.325660636,2.116794132,155,4
E4597,HR,43,72,5.973030922,-1,12,5,19,7,2.437964235,2.724783557,115,17
E4598,Sales,52,77,6.447223522,-1,7,8,30,12,2.014173464,4.028346928,129,15
E4599,Sales,43,78,6.355083142,-1,5,4,17,4,1.223643544,2.311326694,121,9
E4600,HR,50,57,6.420520756,-1,8,5,23,5,1.75189861,3.099512926,107,13
E4601,HR,57,78,6.713075241,-1,7,5,31,4,1.555799681,4.019149176,135,12
E4602,Sales,45,74,12.50956678,1,9,3,25,8,0.888259424,1.850540466,119,12
E4603,HR,50,68,10.24648245,0,8,11,23,3,1.689417121,2.045083883,118,19
E4604,Marketing,61,72,12.64846307,1,3,7,19,11,0.732683229,1.392098136,133,10
E4605,Engineering,46,88,6.64001632,-1,8,6,16,11,1.832456819,2.094236364,134,14
E4606,Engineering,50,69,5.374456338,-2,11,6,15,8,2.6668941,2.353141853,119,17
E4607,Engineering,50,66,7.410470974,-1,6,4,25,2,1.188994056,2.972485141,116,10
E4608,Marketing,45,65,12.078755,1,6,3,30,4,0.688138894,2.293796312,110,9
E4609,Support,48,68,12.24434175,1,8,6,25,12,1.057055176,1.887598528,116,14
E4610,HR,50,60,9.318710373,0,9,5,17,5,1.356758693,1.647492699,110,14
E4611,Finance,56,71,10.96728846,0,11,3,22,4,1.169855649,1.838344591,127,14
E4612,HR,41,76,8.480211967,-1,8,6,21,2,1.47676023,2.215140344,117,14
E4613,Sales,31,71,7.823084577,-1,8,5,18,4,1.473407615,2.040102851,102,13
E4614,Operations,49,67,11.19296081,0,5,3,16,11,0.656116273,1.312232546,116,8
E4615,Engineering,54,75,11.98866605,1,10,3,17,6,1.000872603,1.308833404,129,13
E4616,HR,60,71,15.37152015,2,8,5,23,4,0.794061876,1.404878703,131,13
E4617,Finance,34,73,7.004737732,-1,9,5,22,2,1.748964235,2.748372369,107,14
E4618,Sales,45,69,6.630147445,-1,8,4,20,11,1.572708796,2.621181326,114,12
E4619,Marketing,42,75,8.514010306,-1,5,8,23,3,1.36640592,2.417487396,117,13
E4620,Support,50,70,11.83959352,1,6,4,14,8,0.778840855,1.090377197,120,10
E4621,Marketing,54,64,16.02331006,2,13,3,19,2,0.939887715,1.116116662,118,16
E4622,Finance,50,61,10.42495834,0,12,5,24,5,1.487970415,2.100664115,111,17
E4623,Sales,54,63,7.41367108,-1,7,6,16,7,1.545104375,1.901666924,117,13
E4624,Engineering,54,80,6.582793971,-1,4,4,19,4,1.055020093,2.505672721,134,8
E4625,HR,43,69,8.252640798,-1,7,4,19,9,1.188849783,2.053467806,112,11
E4626,Sales,40,77,10.68814157,0,13,4,23,3,1.454465613,1.967806418,117,17
E4627,Support,56,60,12.13776597,1,7,6,20,8,0.989513745,1.522328838,116,13
E4628,Marketing,47,74,10.65573659,0,13,5,16,7,1.544303946,1.372714618,121,18
E4629,Support,43,70,7.84046566,-1,8,6,15,2,1.583626987,1.696743201,113,14
E4630,Support,47,73,6.076192032,-1,8,1,23,10,1.271870514,3.250335759,120,9
E4631,Finance,53,72,11.96745814,1,8,4,19,11,0.925393386,1.465206195,125,12
E4632,Finance,36,74,8.347950557,-1,10,5,21,2,1.604629796,2.246481715,110,15
E4633,HR,43,84,8.596351996,0,8,5,19,7,1.354681446,1.979919037,127,13
E4634,Finance,46,68,6.957969309,-1,5,3,15,5,1.005281585,1.884902972,114,8
E4635,Finance,46,81,5.337599199,-2,11,5,16,6,2.524615315,2.524615315,127,16
E4636,Sales,56,78,14.93479408,2,3,5,19,3,0.502046023,1.192359305,134,8
E4637,Engineering,66,64,8.024155408,-1,2,3,24,5,0.554068472,2.659528667,130,5
E4638,HR,53,50,4.106887167,-2,11,8,19,11,3.720465986,3.720465986,103,19
E4639,Sales,47,71,10.48879804,0,4,6,21,4,0.870413073,1.827867453,118,10
E4640,Engineering,58,61,9.555212589,0,11,5,25,1,1.515838726,2.368498009,119,16
E4641,Support,38,74,4.381699476,-2,10,8,22,10,3.344668368,4.087928005,112,18
E4642,Sales,55,69,13.42244323,1,10,6,23,2,1.109382075,1.594736733,124,16
E4643,Operations,62,69,11.98695877,1,6,6,13,8,0.924003857,1.001004179,131,12
E4644,Sales,46,92,12.52753207,1,8,3,16,10,0.813156454,1.182773023,138,11
E4645,Finance,50,65,10.80341928,0,7,4,20,6,0.931933344,1.694424262,115,11
E4646,Engineering,52,77,6.089565165,-1,7,8,23,10,2.115785616,3.244204611,129,15
E4647,HR,44,76,9.813289473,0,11,6,14,9,1.572139546,1.294703155,120,17
E4648,HR,54,58,8.557558432,0,11,4,16,10,1.569438482,1.674067714,112,15
E4649,Engineering,46,63,8.0496382,-1,12,5,26,7,1.878528138,2.873043035,109,17
E4650,Finance,56,63,14.90916389,2,7,4,16,11,0.691425399,1.005709672,119,11
E4651,Marketing,48,63,7.026184438,-1,8,4,14,2,1.495106435,1.74429084,111,12
E4652,Sales,39,64,8.610555189,0,5,3,19,1,0.832418091,1.976992965,103,8
E4653,Finance,51,63,10.11322759,0,5,5,18,9,0.899828598,1.619691477,114,10
E4654,Operations,54,65,11.18159757,0,7,6,18,2,1.067183506,1.4776387,119,13
E4655,Support,41,72,15.07687194,2,9,4,21,11,0.808615012,1.306224251,113,13
E4656,Engineering,51,80,9.509455492,0,7,7,21,9,1.332133716,1.998200574,131,14
E4657,Sales,43,76,10.87274592,0,13,10,25,4,1.937209821,2.105662849,119,23
E4658,HR,37,62,6.38712424,-1,6,4,25,4,1.353706757,3.384266893,99,10
E4659,Support,43,72,11.726536,1,4,5,19,9,0.707183793,1.492943563,115,9
E4660,Marketing,61,79,15.80637225,2,8,4,20,9,0.714014888,1.190024813,140,12
E4661,Operations,45,70,8.717804492,0,11,8,20,2,1.955174136,2.058078038,115,19
E4662,HR,43,67,12.40908275,1,8,6,24,2,1.044068432,1.789831597,110,14
E4663,Engineering,55,74,5.76878741,-1,4,9,14,2,1.920580336,2.068317285,129,13
E4664,Sales,55,80,8.964948556,0,5,5,23,9,1.003517474,2.308090189,135,10
E4665,Engineering,46,65,9.115157005,0,9,6,22,3,1.482923102,2.174953883,111,15
E4666,Support,51,91,11.05624152,0,6,10,28,1,1.327113427,2.322448497,142,16
E4667,Sales,66,66,9.581161536,0,7,7,19,2,1.323106159,1.795644073,132,14
E4668,Finance,54,65,13.3876979,1,12,6,26,7,1.251068804,1.807099384,119,18
E4669,Marketing,42,70,8.458990512,-1,9,4,23,1,1.374353847,2.431549114,112,13
E4670,Finance,51,63,12.19254709,1,2,2,10,11,0.303201495,0.758003737,114,4
E4671,Finance,50,66,10.48429641,0,7,5,21,6,1.04490511,1.828583943,116,12
E4672,Engineering,49,73,6.763766761,-1,16,5,24,6,2.704872602,3.091282974,122,21
E4673,Support,50,63,3.314687633,-2,9,10,19,7,4.403563274,4.403563274,113,19
E4674,Marketing,38,77,10.43997899,0,7,7,19,1,1.223778471,1.660842211,115,14
E4675,Sales,46,78,7.946247781,-1,8,5,13,8,1.453123177,1.453123177,124,13
E4676,Sales,52,74,10.82595758,0,8,7,25,8,1.268396229,2.113993715,126,15
E4677,Operations,42,76,6.218373539,-1,7,8,16,2,2.078030448,2.216565811,118,15
E4678,HR,49,65,11.60059756,1,12,3,23,9,1.190419734,1.825310259,114,15
E4679,Operations,51,70,14.70542939,2,10,6,15,3,1.018755973,0.955083725,121,16
E4680,Operations,57,81,9.281829573,0,11,4,15,12,1.458884325,1.458884325,138,15
E4681,Sales,63,71,4.011799324,-2,6,3,18,6,1.795762244,3.591524488,134,9
E4682,Engineering,53,78,9.832875172,0,6,4,22,3,0.923115963,2.030855119,131,10
E4683,Finance,54,62,7.862452082,-1,5,4,28,4,1.0155203,3.15939649,116,9
E4684,Support,46,73,7.157688544,-1,7,4,18,7,1.348421178,2.206507383,119,11
E4685,Finance,43,83,9.371207644,0,9,7,14,3,1.542732587,1.349891014,126,16
E4686,Finance,51,62,12.9899125,1,6,3,20,3,0.643320678,1.429601507,113,9
E4687,Marketing,53,71,8.269324033,-1,8,7,18,1,1.618240979,1.941889175,124,15
E4688,Sales,58,79,12.09227642,1,7,5,27,6,0.916570932,2.062284598,137,12
E4689,Support,60,63,9.35320678,0,6,4,16,1,0.965884311,1.545414898,123,10
E4690,Engineering,51,56,9.728391832,0,6,6,16,2,1.118527379,1.491369839,107,12
E4691,Marketing,46,59,13.27545606,1,10,9,21,1,1.330955727,1.471056329,105,19
E4692,HR,49,69,9.161042526,0,10,4,22,11,1.377811378,2.165132165,118,14
E4693,Engineering,51,84,12.29830892,1,10,6,19,9,1.203160499,1.428753093,135,16
E4694,Operations,59,67,9.317908611,0,6,7,18,5,1.259945255,1.744539584,126,13
E4695,Engineering,46,68,11.67883586,1,6,6,25,8,0.946459133,1.971789861,114,12
E4696,Engineering,47,71,9.203453564,0,6,4,19,9,0.980060323,1.862114614,118,10
E4697,Finance,49,78,10.51351097,0,9,7,24,12,1.389671668,2.084507503,127,16
E4698,Engineering,55,61,10.77157805,0,10,7,23,1,1.444156419,1.953858684,116,17
E4699,Operations,55,76,12.02711824,1,7,1,17,6,0.614103584,1.304970116,131,8
E4700,Operations,40,56,11.4394412,0,8,2,13,8,0.803894632,1.045063021,96,10
E4701,Sales,51,67,7.467095141,-1,8,1,23,6,1.062938334,2.716397964,118,9
E4702,Engineering,40,65,15.46044699,2,3,4,28,7,0.425261842,1.701047366,105,7
E4703,Finance,50,66,10.07852047,0,9,5,23,3,1.263706651,2.076089499,116,14
E4704,Engineering,48,68,12.74636949,1,14,8,23,8,1.600422571,1.673169051,116,22
E4705,HR,58,68,2.830136318,-2,6,6,17,1,3.133047757,4.438484322,126,12
E4706,HR,47,82,12.4101789,1,8,5,20,6,0.969412869,1.491404414,129,13
E4707,Finance,53,58,12.29592735,1,7,6,19,5,0.977743008,1.429009012,111,13
E4708,Sales,46,65,10.70187832,0,13,4,20,8,1.452758227,1.709127326,111,17
E4709,Sales,48,64,3.230272295,-2,11,8,14,4,4.491436644,3.309479632,112,19
E4710,Operations,64,80,7.833438107,-1,8,4,20,11,1.358474453,2.264124088,144,12
E4711,Operations,55,79,6.928771423,-1,7,8,22,5,1.891844171,2.774704784,134,15
E4712,Marketing,49,61,13.4885739,1,7,4,13,6,0.759218959,0.89725877,110,11
E4713,Finance,41,67,6.389871531,-1,6,4,19,6,1.353203497,2.571086645,108,10
E4714,Engineering,49,56,11.66247287,1,8,4,15,7,0.947682189,1.184602736,105,12
E4715,Support,45,71,9.131130169,0,8,5,20,5,1.283173721,1.974113417,116,13
E4716,Finance,44,69,13.24885356,1,12,4,18,9,1.122897357,1.263259527,113,16
E4717,Marketing,56,70,10.68672033,0,6,3,19,6,0.77010485,1.625776905,126,9
E4718,Operations,45,79,8.06349535,-1,9,2,17,4,1.213659805,1.875656062,124,11
E4719,Finance,56,55,7.676674179,-1,8,2,21,11,1.152515329,2.420282192,111,10
E4720,Finance,47,66,8.674917465,0,6,8,17,12,1.447040768,1.757120933,113,14
E4721,Operations,45,61,0.724013344,-3,5,7,26,1,6.960502968,15.08108976,106,12
E4722,Marketing,60,68,15.31156896,2,3,5,20,12,0.490449448,1.226123621,128,8
E4723,Operations,51,94,13.94167758,1,6,8,20,3,0.936976449,1.338537784,145,14
E4724,Sales,50,86,10.20406591,0,7,2,13,9,0.803279816,1.160293067,136,9
E4725,Engineering,52,79,12.81885505,1,8,11,20,3,1.374933013,1.447297908,131,19
E4726,Operations,63,81,9.891239691,0,11,2,19,5,1.19361986,1.744521334,144,13
E4727,Marketing,44,79,11.3089432,0,10,5,17,1,1.218626144,1.38110963,123,15
E4728,HR,56,69,12.96071123,1,4,5,20,3,0.644666296,1.432591769,125,9
E4729,Sales,54,68,9.284648776,0,7,5,25,6,1.166787536,2.430807366,122,12
E4730,HR,54,72,12.32188711,1,1,7,17,9,0.600515523,1.276095486,126,8
E4731,Support,48,64,4.609877407,-2,7,9,31,8,2.852112237,5.525967459,112,16
E4732,Operations,61,83,10.64371916,0,9,4,15,11,1.116481755,1.288248178,144,13
E4733,Sales,65,73,9.956788825,0,11,3,11,8,1.27774663,1.003943781,138,14
E4734,Engineering,47,51,8.979525029,0,10,6,27,8,1.603282717,2.705539585,98,16
E4735,Operations,62,74,9.379887489,0,9,3,13,5,1.156081895,1.252422053,136,12
E4736,Engineering,41,68,9.274211961,0,16,3,21,7,1.849290249,2.043952381,109,19
E4737,Finance,58,72,13.32399504,1,7,3,18,9,0.698129256,1.256632661,130,10
E4738,HR,49,57,9.825312074,0,9,5,19,4,1.293265257,1.755145706,106,14
E4739,Sales,57,74,18.46390891,3,12,3,18,4,0.770657121,0.924788545,131,15
E4740,Engineering,63,82,7.181450871,-1,6,4,19,2,1.222277095,2.32232648,145,10
E4741,Marketing,50,50,11.66411062,1,5,3,27,9,0.631706422,2.132009173,100,8
E4742,Engineering,54,72,12.68456899,1,7,4,26,3,0.803825098,1.899950231,126,11
E4743,Marketing,53,80,8.831254796,0,5,6,21,5,1.118880573,2.13604473,133,11
E4744,Operations,44,69,6.359447691,-1,4,4,15,5,1.087038095,2.038196429,113,8
E4745,Sales,44,63,8.645417043,0,8,2,9,9,1.036761807,0.933085626,107,10
E4746,Engineering,44,72,6.036832409,-1,9,8,20,4,2.415859724,2.84218791,116,17
E4747,Support,45,71,7.529405281,-1,14,3,21,11,1.993104963,2.462070837,116,17
E4748,Engineering,48,69,11.16144783,0,10,1,9,11,0.904497569,0.740043465,117,11
E4749,Support,60,69,17.77008853,3,5,6,21,11,0.586038792,1.118801329,129,11
E4750,Sales,41,77,15.20669921,2,8,4,16,10,0.740434548,0.987246063,118,12
E4751,Engineering,53,75,8.175932091,-1,9,6,25,3,1.634711313,2.724518856,128,15
E4752,Marketing,51,75,12.83698919,1,8,4,20,1,0.867240686,1.445401143,126,12
E4753,Engineering,53,75,8.909138526,0,12,9,29,10,2.119255871,2.926591441,128,21
E4754,HR,52,62,7.389848093,-1,9,5,16,12,1.668683371,1.90706671,114,14
E4755,Operations,54,84,9.751873519,0,6,2,17,4,0.744056372,1.58111979,138,8
E4756,Finance,46,75,3.435532684,-2,7,4,22,2,2.479972708,4.959945415,121,11
E4757,Marketing,52,65,4.957888018,-2,6,8,25,7,2.349825971,4.196117806,117,14
E4758,HR,47,66,12.7392033,1,5,6,14,8,0.800628665,1.018981937,113,11
E4759,Support,52,81,14.09178746,1,8,4,17,2,0.795134442,1.126440459,133,12
E4760,Operations,49,67,2.529961936,-2,6,6,20,12,3.399470084,5.665783474,116,12
E4761,Sales,65,77,14.3720458,1,8,9,20,10,1.105903549,1.301062999,142,17
E4762,Marketing,44,64,13.47585533,1,10,3,18,4,0.898047107,1.24344984,108,13
E4763,Finance,49,64,8.954103758,0,9,3,16,1,1.205532943,1.607377257,113,12
E4764,Operations,42,62,11.36497186,0,3,2,17,12,0.404368086,1.374851491,104,5
E4765,Support,48,65,15.45186268,2,10,1,16,1,0.6686173,0.972534254,113,11
E4766,Finance,48,61,13.67790951,1,9,8,22,7,1.15820308,1.498851044,109,17
E4767,Sales,67,78,11.4822534,0,7,5,9,2,0.961364876,0.721023657,145,12
E4768,Sales,45,75,8.098794419,-1,9,5,25,8,1.538665383,2.747616755,120,14
E4769,Support,45,59,8.769595194,0,7,3,28,12,1.023583864,2.86603482,104,10
E4770,Marketing,39,52,12.09792369,1,7,6,12,12,0.992523724,0.916175745,91,13
E4771,Support,61,67,11.62545324,1,10,2,16,10,0.950460928,1.267281237,128,12
E4772,Engineering,55,76,13.48573275,1,13,9,18,9,1.518735737,1.242601967,131,22
E4773,Sales,42,65,5.665547766,-1,7,5,21,7,1.800302154,3.150528769,107,12
E4774,Operations,47,68,11.33487757,0,7,2,22,1,0.729638373,1.783560467,115,9
E4775,Engineering,56,68,12.15785728,1,6,3,20,3,0.684001947,1.520004328,124,9
E4776,HR,54,65,9.273403643,0,7,2,20,4,0.876048515,1.946774477,119,9
E4777,Finance,50,72,17.14602086,2,4,4,24,8,0.440868004,1.322604012,122,8
E4778,Engineering,55,80,7.406074462,-1,9,4,15,10,1.546500695,1.784423879,135,13
E4779,Finance,51,68,9.831398578,0,7,4,18,7,1.015565988,1.661835253,119,11
E4780,Support,51,76,12.19283104,1,9,4,12,2,0.98538365,0.909584908,127,13
E4781,Engineering,58,70,12.59049787,1,8,3,34,7,0.809389038,2.501747937,128,11
E4782,Support,44,61,9.26389434,0,9,6,31,10,1.461433595,3.020296096,105,15
E4783,HR,43,74,9.258436038,0,6,4,16,4,0.974807462,1.559691939,117,10
E4784,Sales,44,66,12.09614784,1,5,3,16,7,0.610866653,1.221733306,110,8
E4785,HR,54,68,11.39287471,0,5,4,22,6,0.726223754,1.775213622,122,9
E4786,Sales,33,58,10.27630457,0,4,9,25,5,1.152859957,2.217038379,91,13
E4787,Support,40,67,4.420245432,-2,4,9,17,2,2.398415379,3.136389341,107,13
E4788,Sales,49,65,10.44316552,0,10,3,20,10,1.136049284,1.74776813,114,13
E4789,Finance,60,73,14.84581272,2,6,7,17,10,0.820406011,1.072838629,133,13
E4790,Operations,53,77,11.76833451,1,4,7,20,4,0.861506251,1.566375002,130,11
E4791,HR,54,71,7.672761404,-1,7,3,14,7,1.153035295,1.614249412,125,10
E4792,Engineering,51,67,5.623883997,-1,7,4,25,5,1.660657102,3.774220685,118,11
E4793,HR,55,60,12.87632715,1,10,7,19,3,1.225108043,1.369238401,115,17
E4794,Finance,55,64,8.620695893,0,6,9,23,9,1.559138774,2.390679454,119,15
E4795,Sales,47,63,14.00571037,1,5,5,22,3,0.666412969,1.466108532,110,10
E4796,Finance,68,84,13.93701148,1,10,2,15,10,0.803373554,1.004216942,152,12
E4797,Marketing,46,84,9.553750755,0,8,4,18,10,1.137036517,1.705554776,130,12
E4798,Marketing,51,72,10.97508733,0,9,2,17,6,0.918573677,1.419613864,123,11
E4799,Engineering,55,66,11.34958868,0,6,6,23,8,0.971692282,1.862410206,121,12
E4800,Finance,60,65,6.399439806,-1,5,2,13,4,0.946017561,1.756889757,125,7
E4801,Support,56,61,15.11951758,2,11,5,21,2,0.992585536,1.302768516,117,16
E4802,Engineering,61,70,11.49706044,0,6,8,20,7,1.120263447,1.600376353,131,14
E4803,Support,54,76,10.45910364,0,4,0,25,1,0.349067443,2.181671516,130,4
E4804,Engineering,52,75,12.9594583,1,11,4,18,8,1.074540264,1.289448316,127,15
E4805,Marketing,48,63,10.91507683,0,9,3,18,11,1.007127371,1.510691057,111,12
E4806,Engineering,54,57,6.736864686,-1,4,8,12,12,1.551015881,1.551015881,111,12
E4807,Marketing,57,67,7.583398272,-1,10,6,16,9,1.864063567,1.864063567,124,16
E4808,Sales,45,61,3.562962999,-2,15,7,28,11,4.821428533,6.136363587,106,22
E4809,Support,49,73,10.19820844,0,6,5,25,12,0.982299986,2.232499969,122,11
E4810,Finance,52,69,11.65748075,1,7,1,14,10,0.632037303,1.10606528,121,8
E4811,Engineering,65,77,9.437515285,0,9,4,13,10,1.245507158,1.245507158,142,13
E4812,Marketing,45,81,6.533017436,-1,8,3,15,8,1.460238224,1.991233941,126,11
E4813,HR,56,68,8.514793292,-1,8,4,16,9,1.261193978,1.68159197,124,12
E4814,Support,57,85,8.893504885,0,7,6,15,2,1.313993388,1.516146217,142,13
E4815,Engineering,39,72,12.60214508,1,7,11,22,4,1.323320689,1.617391954,111,18
E4816,Operations,49,75,14.29546511,1,7,5,17,3,0.784546264,1.11144054,124,12
E4817,Sales,43,65,1.790880965,-3,10,4,24,11,5.016337199,8.599435198,108,14
E4818,Sales,51,68,9.76353498,0,7,4,20,11,1.021969086,1.85812561,119,11
E4819,HR,47,69,8.18768514,-1,8,0,27,3,0.870730753,2.938716291,116,8
E4820,Marketing,45,88,9.217950821,0,12,8,21,11,1.957339622,2.055206603,133,20
E4821,Engineering,56,81,12.5262399,1,7,5,26,8,0.887164511,1.922189773,137,12
E4822,Support,51,75,8.501474341,-1,6,5,16,10,1.157715067,1.683949188,126,11
E4823,Marketing,56,76,12.05327793,1,7,5,15,3,0.919309316,1.149136644,132,12
E4824,Sales,40,68,15.97409779,2,9,4,27,7,0.765872812,1.590658917,108,13
E4825,Marketing,53,60,8.649285795,0,6,5,19,1,1.139980744,1.969057649,113,11
E4826,Sales,61,83,9.348948879,0,9,1,18,10,0.966281708,1.739307075,144,10
E4827,Marketing,43,86,9.281719912,0,5,3,27,3,0.778079939,2.626019793,129,8
E4828,HR,49,76,17.16097272,2,11,4,14,4,0.825946948,0.770883818,125,15
E4829,Finance,38,66,8.499666641,-1,5,2,25,3,0.736867962,2.631671294,104,7
E4830,HR,48,55,14.40990469,1,5,5,21,3,0.64893328,1.362759889,103,10
E4831,HR,40,86,9.892286213,0,6,7,12,2,1.193505178,1.101697088,126,13
E4832,Finance,49,64,10.51080794,0,4,7,25,2,0.955623624,2.171871872,113,11
E4833,Finance,51,67,12.48496276,1,6,4,26,8,0.74156675,1.928073549,118,10
E4834,Engineering,58,76,8.881870611,0,9,3,20,1,1.214344983,2.023908305,134,12
E4835,Support,51,78,12.9475647,1,8,10,23,7,1.290547876,1.649033397,129,18
E4836,Support,45,73,9.169577231,0,8,8,22,9,1.573320074,2.163315102,118,16
E4837,Engineering,53,61,6.794396682,-1,9,5,24,1,1.796162111,3.079135048,114,14
E4838,HR,50,74,13.05008245,1,8,9,22,11,1.209957312,1.56582711,124,17
E4839,HR,50,58,11.83095738,1,8,7,24,6,1.169047606,1.870476169,108,15
E4840,Sales,49,66,8.241664538,-1,5,8,13,7,1.406673002,1.406673002,115,13
E4841,Sales,53,77,13.45826787,1,7,2,25,2,0.622481205,1.729114457,130,9
E4842,Support,42,77,7.046874444,-1,6,4,20,3,1.242718532,2.485437065,119,10
E4843,Engineering,47,81,11.26866053,0,11,4,16,10,1.222627357,1.304135847,128,15
E4844,Operations,44,70,4.92188652,-2,3,6,12,5,1.519785962,2.026381282,114,9
E4845,Operations,49,65,8.832162838,0,11,8,16,9,1.932433414,1.627312349,114,19
E4846,Engineering,41,65,7.473359268,-1,12,4,26,1,1.888271168,3.068440647,106,16
E4847,Sales,53,69,6.222187867,-1,8,3,21,10,1.523084168,2.907706139,122,11
E4848,Support,59,64,10.07353565,0,8,4,14,12,1.083664728,1.264275516,123,12
E4849,Support,48,59,10.99616451,0,4,6,15,10,0.833599772,1.250399658,107,10
E4850,Sales,53,69,11.84438047,1,10,4,15,2,1.089970827,1.167825886,122,14
E4851,Operations,58,75,10.00504114,0,11,4,12,4,1.363011716,1.090409372,133,15
E4852,Marketing,62,67,11.29258688,0,5,4,11,10,0.732148578,0.894848261,129,9
E4853,Marketing,56,67,6.63066175,-1,6,5,12,9,1.441552563,1.572602796,123,11
E4854,Sales,34,70,7.35921584,-1,6,7,16,3,1.555169797,1.914055135,104,13
E4855,Marketing,50,79,9.946548046,0,8,5,31,2,1.187588996,2.83194299,129,13
E4856,Finance,38,60,7.371680641,-1,11,8,18,12,2.269556236,2.150105907,98,19
E4857,Engineering,41,74,10.01663321,0,5,3,24,6,0.726174671,2.178524013,115,8
E4858,Engineering,60,69,8.049975426,-1,7,5,15,8,1.325970451,1.657463064,129,12
E4859,Sales,47,70,9.524419105,0,8,4,26,9,1.140205448,2.470445137,117,12
E4860,HR,61,79,5.006661055,-2,10,7,17,1,2.830191323,2.830191323,140,17
E4861,Operations,39,67,4.863548583,-2,11,6,20,9,2.899268209,3.410903776,106,17
E4862,Sales,43,77,7.848914175,-1,8,5,29,5,1.469106801,3.277238249,120,13
E4863,Marketing,44,77,6.019711906,-1,5,6,25,11,1.567015876,3.561399718,121,11
E4864,Operations,52,72,2.126868529,-3,10,3,19,8,4.157514101,6.076366763,124,13
E4865,HR,53,61,11.44771731,0,5,9,17,12,1.124704205,1.365712248,114,14
E4866,Marketing,55,68,12.91399203,1,8,3,25,8,0.790571101,1.796752503,123,11
E4867,Support,45,65,12.62558693,1,7,8,21,7,1.100870008,1.541218012,110,15
E4868,Finance,46,65,9.566917569,0,9,4,20,4,1.2302547,1.892699538,111,13
E4869,Marketing,42,70,9.505884221,0,10,5,22,3,1.427771303,2.094064577,112,15
E4870,Finance,47,63,10.2978331,0,11,3,26,2,1.239175678,2.30132626,110,14
E4871,Operations,44,65,8.036115376,-1,9,2,17,7,1.217337267,1.881339413,109,11
E4872,Finance,61,75,4.472217822,-2,9,3,21,12,2.192895164,3.837566537,136,12
E4873,Operations,46,70,13.56242267,1,13,2,17,5,1.030048388,1.167388173,116,15
E4874,Operations,49,62,10.04304282,0,4,5,16,7,0.814992765,1.448876027,111,9
E4875,Operations,50,70,9.858661289,0,9,5,26,4,1.289293369,2.394401972,120,14
E4876,Operations,49,66,9.049924383,0,6,9,23,11,1.492548543,2.288574433,115,15
E4877,Operations,55,62,11.78091142,1,8,5,19,6,1.017141859,1.486591947,117,13
E4878,Marketing,41,76,9.645782041,0,5,9,24,4,1.315074829,2.254413993,117,14
E4879,Operations,56,76,8.531847054,-1,8,2,27,2,1.04911461,2.832609446,132,10
E4880,Marketing,52,75,8.993105762,0,6,6,29,11,1.200827879,2.902000708,127,12
E4881,Operations,53,77,10.19470635,0,6,2,16,1,0.714623479,1.429246958,130,8
E4882,Finance,62,78,6.54196671,-1,12,7,20,10,2.519236789,2.651828199,140,19
E4883,Support,45,75,14.2426837,1,4,6,21,2,0.656052451,1.377710147,120,10
E4884,Operations,58,77,8.178732351,-1,7,4,14,6,1.198422569,1.525265087,135,11
E4885,HR,50,67,7.614471856,-1,11,2,21,9,1.509088452,2.437758269,117,13
E4886,Operations,56,63,8.866236389,0,8,3,17,9,1.114913485,1.723048114,119,11
E4887,Operations,51,60,12.72747705,1,10,4,25,9,1.01985237,1.821164947,111,14
E4888,Finance,49,78,9.194477817,0,7,6,12,10,1.275200185,1.177107863,127,13
E4889,Engineering,40,78,13.49262637,1,7,10,21,12,1.1730103,1.449012723,118,17
E4890,Finance,49,79,9.010992108,0,10,4,13,5,1.398462795,1.298572595,128,14
E4891,HR,56,57,5.737517993,-1,10,6,25,8,2.374761747,3.71056523,113,16
E4892,Engineering,47,74,7.495129519,-1,9,8,17,8,2.001146653,2.001146653,121,17
E4893,Sales,47,78,7.941682278,-1,8,2,23,12,1.118357786,2.572222909,125,10
E4894,Sales,45,68,11.94574281,1,6,1,12,2,0.540718296,0.926945651,113,7
E4895,HR,48,75,8.625091692,0,7,5,26,7,1.24674137,2.701272968,123,12
E4896,Finance,60,71,6.458431992,-1,7,2,21,2,1.206687949,2.815605213,131,9
E4897,Marketing,47,71,5.657290012,-1,8,3,18,8,1.652323991,2.703802894,118,11
E4898,HR,41,57,4.505277403,-2,15,5,10,3,3.632877789,1.816438895,98,20
E4899,Support,42,79,17.96088119,3,10,9,22,8,1.002063133,1.160283627,121,19
E4900,Engineering,42,67,7.751902962,-1,5,7,15,4,1.371130376,1.71391297,109,12
E4901,Engineering,40,72,11.32819882,0,9,7,26,5,1.297837603,2.108986104,112,16
E4902,Operations,33,82,6.379806395,-1,3,9,18,6,1.626058918,2.439088377,115,12
E4903,Sales,59,73,13.68292099,1,8,9,20,12,1.157807769,1.362126788,132,17
E4904,Engineering,58,71,7.427654162,-1,6,3,18,1,1.067912829,2.135825659,129,9
E4905,HR,63,61,15.61221211,2,8,6,24,6,0.842753506,1.444720297,124,14
E4906,Engineering,54,59,15.91582147,2,9,3,23,10,0.709395049,1.359673844,113,12
E4907,HR,43,70,6.653737877,-1,12,3,24,1,1.95982672,3.135722752,113,15
E4908,Marketing,48,58,13.71711782,1,14,3,15,1,1.155117477,1.019221303,106,17
E4909,Operations,39,67,15.63220734,2,5,3,23,6,0.480994485,1.382859143,106,8
E4910,Sales,59,77,5.19197828,-2,4,6,22,9,1.614992745,3.552984039,136,10
E4911,Engineering,45,76,5.538590723,-1,11,3,19,12,2.141134167,2.905824941,121,14
E4912,HR,50,62,3.721624938,-2,10,11,16,10,4.447621375,3.388663905,112,21
E4913,Finance,50,72,7.180886254,-1,11,4,20,5,1.833542178,2.444722904,122,15
E4914,Sales,50,54,6.983350659,-1,9,7,24,10,2.004171016,3.006256524,104,16
E4915,Marketing,44,71,8.998027315,0,3,8,19,9,1.100217038,1.900374884,115,11
E4916,HR,46,71,6.169971315,-1,10,2,26,4,1.673646863,3.62623487,117,12
E4917,Support,54,72,12.07520101,1,4,5,16,7,0.688325938,1.223690556,126,9
E4918,Support,49,87,10.09142076,0,9,5,19,2,1.26223685,1.713035724,136,14
E4919,Operations,46,65,11.27316744,0,10,5,20,12,1.222178388,1.629571184,111,15
E4920,Operations,53,60,13.0887647,1,7,4,16,6,0.78076398,1.135656698,113,11
E4921,Marketing,46,66,10.78926102,0,9,0,20,7,0.763406628,1.696459173,112,9
E4922,Marketing,44,67,9.328372545,0,9,4,16,10,1.258668773,1.549130798,111,13
E4923,Operations,46,72,7.535975875,-1,4,5,20,8,1.054360993,2.343024429,118,9
E4924,Engineering,55,80,12.69254424,1,5,4,18,7,0.657292016,1.314584031,135,9
E4925,Engineering,45,70,10.81135658,0,7,7,18,7,1.185299919,1.523957039,115,14
E4926,HR,55,71,10.65633096,0,11,3,18,2,1.201064044,1.544225199,126,14
E4927,Finance,53,63,8.18428176,-1,13,7,21,5,2.17763354,2.286515217,116,20
E4928,HR,46,63,10.90067145,0,7,4,24,12,0.924317594,2.016692932,109,11
E4929,Finance,40,57,7.65512676,-1,6,4,21,11,1.15538458,2.426307619,97,10
E4930,Marketing,61,63,10.93002672,0,7,2,18,8,0.754398981,1.508797961,124,9
E4931,Sales,28,78,9.205632417,0,8,10,19,2,1.763731954,1.861717062,106,18
E4932,HR,50,90,12.14666216,1,16,11,21,3,2.05375324,1.597363631,140,27
E4933,HR,49,80,6.014545142,-1,13,7,14,7,2.851218375,1.995852862,129,20
E4934,Finance,50,86,10.14271262,0,8,2,12,2,0.897447537,1.076937045,136,10
E4935,Marketing,42,76,12.10843266,1,8,7,16,8,1.144301564,1.220588335,118,15
E4936,Marketing,62,73,10.22371084,0,15,4,25,6,1.692844753,2.227427307,135,19
E4937,Support,43,74,5.733025249,-1,8,4,17,9,1.782259765,2.524868001,117,12
E4938,Finance,43,85,7.766388943,-1,9,3,18,1,1.368864658,2.053296987,128,12
E4939,Marketing,38,68,13.80169463,1,9,5,20,11,0.945837646,1.351196637,106,14
E4940,Operations,56,74,9.787678212,0,7,4,13,3,1.01968188,1.205078585,130,11
E4941,Engineering,48,79,7.54213641,-1,9,6,17,9,1.756000991,1.990134456,127,15
E4942,Support,54,71,13.76271186,1,9,4,21,5,0.880597015,1.42250287,125,13
E4943,Operations,51,67,14.64900647,2,5,4,16,11,0.575116383,1.022429126,118,9
E4944,Sales,46,63,6.463729894,-1,8,8,25,5,2.143700298,3.349531716,109,16
E4945,HR,54,91,8.491068734,-1,8,5,17,9,1.369708761,1.791157611,145,13
E4946,Support,67,75,8.966888777,0,9,3,23,6,1.203986547,2.307640881,142,12
E4947,Sales,48,74,11.5996226,1,1,3,17,1,0.317469826,1.349246762,122,4
E4948,HR,57,70,9.458894276,0,8,5,19,1,1.242961221,1.816635631,127,13
E4949,Engineering,45,69,10.36729043,0,5,5,20,12,0.87971712,1.759434241,114,10
E4950,Marketing,42,59,9.561889207,0,5,6,18,7,1.041480344,1.704240562,101,11
E4951,Operations,52,66,16.59967412,2,4,5,10,11,0.511373105,0.568192339,118,9
E4952,Finance,47,64,11.72054494,1,7,9,13,1,1.257807749,1.021968796,111,16
E4953,Operations,48,66,9.119174533,0,16,6,18,1,2.17409038,1.77880122,114,22
E4954,Engineering,48,74,9.166444045,0,10,1,29,8,1.081990906,2.852521479,122,11
E4955,Sales,56,66,11.41942747,0,6,6,22,4,0.966228115,1.771418212,122,12
E4956,Finance,49,76,7.134546584,-1,10,8,12,6,2.212784673,1.475189782,125,18
E4957,Marketing,48,87,10.81039282,0,7,8,18,1,1.270067832,1.524081398,135,15
E4958,Engineering,47,67,10.47783045,0,6,2,19,9,0.696995833,1.655365104,114,8
E4959,Finance,52,64,7.40614282,-1,4,1,18,7,0.594803123,2.141291242,116,5
E4960,Engineering,54,69,3.056265569,-2,7,2,26,8,2.218789634,6.409836722,123,9
E4961,Engineering,40,50,4.789108901,-2,19,4,22,2,3.972977602,3.800239445,90,23
E4962,Marketing,51,68,9.311448864,0,8,3,24,2,1.066775401,2.327509967,119,11
E4963,Support,41,83,12.72105691,1,9,7,14,8,1.166090929,1.020329563,124,16
E4964,HR,57,81,8.652360289,0,9,4,12,9,1.346820841,1.243219238,138,13
E4965,Finance,43,62,12.59800613,1,6,7,19,10,0.956022514,1.397263674,105,13
E4966,Marketing,48,71,8.899986425,0,10,3,15,3,1.313133114,1.515153593,119,13
E4967,Engineering,53,60,6.84666545,-1,7,10,16,10,2.1665254,2.039082729,113,17
E4968,Marketing,44,67,6.164950151,-1,8,3,12,8,1.535251435,1.674819747,111,11
E4969,Support,62,74,7.220273835,-1,5,4,24,8,1.094854038,2.919610767,136,9
E4970,HR,52,75,10.42221127,0,6,5,16,11,0.963035943,1.400779554,127,11
E4971,Operations,50,73,9.863189689,0,7,3,18,5,0.920539941,1.656971895,123,10
E4972,Finance,46,79,9.255492314,0,5,6,20,8,1.072595997,1.950174539,125,11
E4973,HR,41,75,9.380325839,0,18,3,15,4,2.023057881,1.445041344,116,21
E4974,Sales,56,60,13.31512267,1,5,4,28,5,0.628705755,1.955973459,116,9
E4975,Finance,45,73,15.63872612,2,7,4,12,10,0.661108304,0.721209059,118,11
E4976,HR,48,64,7.786529652,-1,7,10,23,4,1.934779791,2.617643246,112,17
E4977,Engineering,50,66,9.435668871,0,6,6,14,6,1.149902335,1.341552724,116,12
E4978,Finance,55,71,6.335913955,-1,6,1,18,5,0.954209665,2.453681997,126,7
E4979,Finance,44,66,9.956372494,0,12,6,26,11,1.642879521,2.373048198,110,18
E4980,Marketing,65,70,9.055274924,0,9,8,18,6,1.690654918,1.790105207,135,17
E4981,Engineering,58,85,10.64399909,0,5,6,9,10,0.94469262,0.772930325,143,11
E4982,Sales,53,66,12.63490946,1,9,2,17,7,0.806752699,1.246799625,119,11
E4983,Operations,41,78,6.37095904,-1,7,11,19,3,2.442016012,2.577683568,119,18
E4984,Support,50,78,9.362341679,0,11,10,18,8,2.02656896,1.737059109,128,21
E4985,HR,46,81,9.169047515,0,12,5,13,2,1.671739657,1.278389149,127,17
E4986,Marketing,55,63,10.47635106,0,10,6,27,5,1.394171363,2.352664175,118,16
E4987,HR,43,75,14.20129331,1,11,5,16,9,1.052542022,1.052542022,118,16
E4988,Sales,48,63,8.048527659,-1,7,3,17,10,1.105152172,1.878758693,111,10
E4989,Sales,44,61,11.82756507,1,7,3,30,11,0.779571177,2.33871353,105,10
E4990,Finance,52,73,15.01659311,2,8,7,16,10,0.936528755,0.998964005,125,15
E4991,Support,51,72,7.462152616,-1,9,2,22,7,1.29990565,2.599811301,123,11
E4992,Sales,41,64,10.4417392,0,6,4,20,11,0.873993003,1.747986005,105,10
E4993,HR,54,80,10.41561204,0,6,3,20,4,0.788393996,1.751986659,134,9
E4994,Engineering,41,81,6.111347264,-1,8,7,21,2,2.109304952,2.953026933,122,15
E4995,Engineering,61,67,11.73749739,1,6,8,19,9,1.099117006,1.491658794,128,14
E4996,Finance,56,71,13.36813548,1,8,4,28,2,0.835181435,1.948756681,127,12
E4997,Operations,50,85,7.995985514,-1,13,4,19,9,1.889731811,2.112053201,135,17
E4998,HR,57,71,9.131077739,0,7,4,19,9,1.085767999,1.875417452,128,11
E4999,HR,58,67,4.75910328,-2,9,7,21,2,2.778210291,3.646401007,125,16
E5000,Sales,50,69,13.15597495,1,3,4,25,2,0.494490844,1.766038729,119,7
